AAAAAAGTCAT -> AAAAAGTCATT
AAAAAGTCATT -> AAAAGTCATTA
AAAAGTCATTA -> AAAGTCATTAG
AAACAAAGTCT -> AACAAAGTCTC
AAACACCGGTC -> AACACCGGTCA
AAACCCAACTA -> AACCCAACTAC
AAACGTCAGAT -> AACGTCAGATG
AAAGACGCACG -> AAGACGCACGT
AAAGTCATTAG -> AAGTCATTAGC
AAAGTCTCCTT -> AAGTCTCCTTA
AAAGTTACTAC -> AAGTTACTACG
AAATGAGAAGG -> AATGAGAAGGT
AAATGCTGCGT -> AATGCTGCGTG
AAATGGCGTGG -> AATGGCGTGGC
AAATGTCGGAT -> AATGTCGGATA
AACAAAGTCTC -> ACAAAGTCTCC
AACAACCGCTG -> ACAACCGCTGC
AACAACGAAAT -> ACAACGAAATG
AACACCGGTCA -> ACACCGGTCAT
AACACTACTAC -> ACACTACTACC
AACATAAGGTC -> ACATAAGGTCC
AACATCCAACA -> ACATCCAACAC
AACATCCACAC -> ACATCCACACC
AACATTACTTT -> ACATTACTTTT
AACCAAGTGCA -> ACCAAGTGCAG
AACCATGTTAG -> ACCATGTTAGA
AACCCAACTAC -> ACCCAACTACG
AACCCACGCGC -> ACCCACGCGCT
AACCCCATCCT -> ACCCCATCCTG
AACCGCTGCCG -> ACCGCTGCCGT
AACCTAACCCC -> ACCTAACCCCA
AACCTGCGGCC -> ACCTGCGGCCC
AACGAAATGGC -> ACGAAATGGCG
AACGACTTAAG -> ACGACTTAAGA
AACGTACACGC -> ACGTACACGCC
AACGTCAGATG -> ACGTCAGATGG
AACGTCGTTAG -> ACGTCGTTAGA
AACTACGAATG -> ACTACGAATGT
AACTGTGAAAC -> ACTGTGAAACA
AAGAAGCATGC -> AGAAGCATGCC
AAGAATATGTT -> AGAATATGTTC
AAGACGCACGT -> AGACGCACGTA
AAGACTATGGG -> AGACTATGGGC
AAGACTTCGGT -> AGACTTCGGTG
AAGAGATGACC -> AGAGATGACCG
AAGAGCACGGA -> AGAGCACGGAC
AAGATAGCATC -> AGATAGCATCC
AAGCATGCCCA -> AGCATGCCCAC
AAGCATTTGCT -> AGCATTTGCTT
AAGCCTCATGA -> AGCCTCATGAC
AAGCGTCATCG -> AGCGTCATCGG
AAGCTACGGGT -> AGCTACGGGTC
AAGCTTCCGAA -> AGCTTCCGAAG
AAGGACGCAGG -> AGGACGCAGGA
AAGGCCGGGAA -> AGGCCGGGAAC
AAGGCGCATGA -> AGGCGCATGAT
AAGGTCCTTGA -> AGGTCCTTGAC
AAGGTGGAACT -> AGGTGGAACTG
AAGTCACCACT -> AGTCACCACTC
AAGTCATTAGC -> AGTCATTAGCG
AAGTCGATAGC -> AGTCGATAGCC
AAGTCTCCTTA -> AGTCTCCTTAG
AAGTGAATTCC -> AGTGAATTCCT
AAGTGCAGTAC -> AGTGCAGTACA
AAGTTACTACG -> AGTTACTACGT
AAGTTTTCACC -> AGTTTTCACCG
AATAAAGTTAC -> ATAAAGTTACT
AATACAATAGC -> ATACAATAGCA
AATACCTAAGA -> ATACCTAAGAG
AATAGCATCTC -> ATAGCATCTCC
AATATGGAGGA -> ATATGGAGGAG
AATATGTTCAT -> ATATGTTCATG
AATCGGGGTAG -> ATCGGGGTAGG
AATCTTTATGA -> ATCTTTATGAT
AATGAGAAGGT -> ATGAGAAGGTG
AATGCTGCGTG -> ATGCTGCGTGA
AATGGCGTGGC -> ATGGCGTGGCG
AATGGTGAAAC -> ATGGTGAAACG
AATGGTTCATG -> ATGGTTCATGT
AATGTAATAAA -> ATGTAATAAAG
AATGTCGGATA -> ATGTCGGATAA
AATGTTCGTCG -> ATGTTCGTCGA
AATTAAGGCCG -> ATTAAGGCCGG
AATTCACACCA -> ATTCACACCAT
AATTCAGTGCA -> ATTCAGTGCAC
AATTCCTCATG -> ATTCCTCATGG
AATTTCGGCTT -> ATTTCGGCTTC
ACAAAGTCTCC -> CAAAGTCTCCT
ACAAATGTCGG -> CAAATGTCGGA
ACAACCGCTGC -> CAACCGCTGCC
ACAACGAAATG -> CAACGAAATGG
ACAAGTGAATT -> CAAGTGAATTC
ACAATACCTAA -> CAATACCTAAG
ACAATAGCATC -> CAATAGCATCT
ACACAAATGTC -> CACAAATGTCG
ACACACAAATG -> CACACAAATGT
ACACACAGGTT -> CACACAGGTTA
ACACAGGTTAC -> CACAGGTTACT
ACACATGTAGC -> CACATGTAGCC
ACACCAAGATA -> CACCAAGATAG
ACACCATATTC -> CACCATATTCG
ACACCGGTCAT -> CACCGGTCATG
ACACCTATGAA -> CACCTATGAAT
ACACGCCTGAA -> CACGCCTGAAT
ACACTACTACC -> CACTACTACCT
ACACTTTTCGA -> CACTTTTCGAC
ACAGACGCGAA -> CAGACGCGAAT
ACAGCCGGACG -> CAGCCGGACGT
ACAGGTTACTT -> CAGGTTACTTC
ACAGGTTTAGA -> CAGGTTTAGAT
ACAGTACGGAT -> CAGTACGGATG
ACATAAGGTCC -> CATAAGGTCCT
ACATATGGTAC -> CATATGGTACG
ACATCATGATC -> CATCATGATCA
ACATCCAACAC -> CATCCAACACT
ACATCCACACC -> CATCCACACCT
ACATCCACTAC -> CATCCACTACC
ACATGTAGCCC -> CATGTAGCCCA
ACATGTTAAAC -> CATGTTAAACA
ACATTACTTTT -> CATTACTTTTT
ACATTCGCCGT -> CATTCGCCGTT
ACCAAGATAGC -> CCAAGATAGCA
ACCAAGTGCAG -> CCAAGTGCAGT
ACCACTCTCCT -> CCACTCTCCTT
ACCAGTATTTC -> CCAGTATTTCT
ACCATATTCGA -> CCATATTCGAC
ACCATCATACG -> CCATCATACGA
ACCATGAGACG -> CCATGAGACGT
ACCATGTTAGA -> CCATGTTAGAT
ACCATTGGCTC -> CCATTGGCTCA
ACCCAACTACG -> CCCAACTACGA
ACCCAATGTAA -> CCCAATGTAAT
ACCCACGCGCT -> CCCACGCGCTA
ACCCCATCCTG -> CCCCATCCTGT
ACCCTAGCCGG -> CCCTAGCCGGA
ACCCTTCACGC -> CCCTTCACGCC
ACCGAAGAATA -> CCGAAGAATAT
ACCGATCTTAC -> CCGATCTTACT
ACCGATTTTCG -> CCGATTTTCGG
ACCGCTGCCGT -> CCGCTGCCGTT
ACCGCTGCGTT -> CCGCTGCGTTA
ACCGCTGGACT -> CCGCTGGACTC
ACCGGTCATGC -> CCGGTCATGCA
ACCGGTTCTTT -> CCGGTTCTTTA
ACCGTGATGTG -> CCGTGATGTGA
ACCTAACCCCA -> CCTAACCCCAT
ACCTAAGAGCA -> CCTAAGAGCAC
ACCTATGAATA -> CCTATGAATAT
ACCTGCGGCCC -> CCTGCGGCCCG
ACCTGTAAGGC -> CCTGTAAGGCG
ACCTTCACTTA -> CCTTCACTTAC
ACCTTCATGAT -> CCTTCATGATC
ACCTTGCGCGA -> CCTTGCGCGAC
ACCTTTCAACC -> CCTTTCAACCC
ACGAAATGGCG -> CGAAATGGCGT
ACGAATGTTCG -> CGAATGTTCGT
ACGACCGCTGG -> CGACCGCTGGA
ACGACTTAAGA -> CGACTTAAGAC
ACGAGACCTTC -> CGAGACCTTCA
ACGAGTACGTT -> CGAGTACGTTC
ACGATTAACCA -> CGATTAACCAA
ACGCACGTATA -> CGCACGTATAT
ACGCAGGAGTG -> CGCAGGAGTGG
ACGCCGCAGCC -> CGCCGCAGCCA
ACGCCGCCCGT -> CGCCGCCCGTC
ACGCCGCTGTA -> CGCCGCTGTAG
ACGCCGGTGTT -> CGCCGGTGTTG
ACGCCTGAATC -> CGCCTGAATCT
ACGCGAATTAA -> CGCGAATTAAG
ACGCGCTACGT -> CGCGCTACGTA
ACGCGCTGGGA -> CGCGCTGGGAG
ACGCGCTGGTT -> CGCGCTGGTTT
ACGCGGTTGCC -> CGCGGTTGCCT
ACGCTACTTGG -> CGCTACTTGGA
ACGCTGTCCAT -> CGCTGTCCATG
ACGGAATGGTT -> CGGAATGGTTC
ACGGACCGAAG -> CGGACCGAAGA
ACGGACGAGAC -> CGGACGAGACC
ACGGATGTAAC -> CGGATGTAACA
ACGGGCAACGA -> CGGGCAACGAC
ACGGGTCTAGG -> CGGGTCTAGGG
ACGGTCCATAG -> CGGTCCATAGG
ACGTACACACA -> CGTACACACAA
ACGTACACGCC -> CGTACACGCCT
ACGTACGGGCA -> CGTACGGGCAA
ACGTACTAGCC -> CGTACTAGCCC
ACGTAGCGCAA -> CGTAGCGCAAC
ACGTAGTCGAC -> CGTAGTCGACC
ACGTATATTTT -> CGTATATTTTG
ACGTCAGATGG -> CGTCAGATGGG
ACGTCCATGCT -> CGTCCATGCTG
ACGTCGTTAGA -> CGTCGTTAGAT
ACGTGCTAACA -> CGTGCTAACAT
ACGTGCTAGAG -> CGTGCTAGAGT
ACGTTAGTATG -> CGTTAGTATGG
ACGTTCCGGCG -> CGTTCCGGCGC
ACTACCGTGAT -> CTACCGTGATG
ACTACCTTCAC -> CTACCTTCACT
ACTACGAATGT -> CTACGAATGTT
ACTACGACCGC -> CTACGACCGCT
ACTACGTGCTA -> CTACGTGCTAG
ACTACTACCTT -> CTACTACCTTC
ACTACTTACCG -> CTACTTACCGC
ACTAGCCCTGG -> CTAGCCCTGGA
ACTATCTTACT -> CTATCTTACTG
ACTATGGGCTC -> CTATGGGCTCA
ACTCATGTTCG -> CTCATGTTCGG
ACTCGAAGGAC -> CTCGAAGGACG
ACTCTCCTTGC -> CTCTCCTTGCG
ACTCTCGTTAC -> CTCTCGTTACA
ACTCTGGTTTC -> CTCTGGTTTCG
ACTCTTATATT -> CTCTTATATTG
ACTCTTGTGTT -> CTCTTGTGTTT
ACTGACTCTTG -> CTGACTCTTGT
ACTGATGCCAG -> CTGATGCCAGG
ACTGCTGTTGC -> CTGCTGTTGCA
ACTGTGAAACA -> CTGTGAAACAC
ACTTAAGACTT -> CTTAAGACTTC
ACTTACCGCTG -> CTTACCGCTGC
ACTTACGGACG -> CTTACGGACGA
ACTTACGTAGC -> CTTACGTAGCG
ACTTCGGTGAG -> CTTCGGTGAGT
ACTTCTGAATT -> CTTCTGAATTT
ACTTGGACTCT -> CTTGGACTCTT
ACTTTTCGACC -> CTTTTCGACCT
ACTTTTTCTAA -> CTTTTTCTAAG
AGAAGCATGCC -> GAAGCATGCCC
AGAAGGTGGAA -> GAAGGTGGAAC
AGAATATGTTC -> GAATATGTTCA
AGACATCCACT -> GACATCCACTA
AGACCATCATA -> GACCATCATAC
AGACCTTCATG -> GACCTTCATGA
AGACGATTAAC -> GACGATTAACC
AGACGCACGTA -> GACGCACGTAT
AGACGCGAATT -> GACGCGAATTA
AGACGTTAGTA -> GACGTTAGTAT
AGACTATGGGC -> GACTATGGGCT
AGACTGATGCC -> GACTGATGCCA
AGACTTCGGTG -> GACTTCGGTGA
AGAGATGACCG -> GAGATGACCGA
AGAGATGGCTG -> GAGATGGCTGG
AGAGCACGGAC -> GAGCACGGACC
AGAGCTTCCGT -> GAGCTTCCGTG
AGAGGTTGAGG -> GAGGTTGAGGT
AGAGTTGTCGC -> GAGTTGTCGCA
AGATACGCTGT -> GATACGCTGTC
AGATAGCATCC -> GATAGCATCCC
AGATATAGCAT -> GATATAGCATT
AGATGAAGCAT -> GATGAAGCATT
AGATGACCGAT -> GATGACCGATC
AGATGGCTGGC -> GATGGCTGGCA
AGATGGGGTAC -> GATGGGGTACA
AGATTATAGTA -> GATTATAGTAA
AGATTGCAGTA -> GATTGCAGTAG
AGCACAGGTTT -> GCACAGGTTTA
AGCACGGACCG -> GCACGGACCGA
AGCATCCCCTG -> GCATCCCCTGC
AGCATCTCCGA -> GCATCTCCGAA
AGCATGCCCAC -> GCATGCCCACA
AGCATTGTTTG -> GCATTGTTTGC
AGCATTTGCTT -> GCATTTGCTTG
AGCCAGCGGGG -> GCCAGCGGGGC
AGCCCAAGAAG -> GCCCAAGAAGC
AGCCCTGGACC -> GCCCTGGACCG
AGCCCTGGTAT -> GCCCTGGTATC
AGCCGGACGTA -> GCCGGACGTAC,GCCGGACGTAG
AGCCGTCAGTC -> GCCGTCAGTCC
AGCCTCATGAC -> GCCTCATGACT
AGCCTTCGGAC -> GCCTTCGGACT
AGCGCAACCAT -> GCGCAACCATG
AGCGCGACTCT -> GCGCGACTCTC
AGCGCTAACAA -> GCGCTAACAAC
AGCGGGGCGGA -> GCGGGGCGGAA
AGCGTCATCGG -> GCGTCATCGGC
AGCGTGTGCGC -> GCGTGTGCGCG
AGCTACGGGTC -> GCTACGGGTCT
AGCTATTAATT -> GCTATTAATTC
AGCTCCTCGTT -> GCTCCTCGTTG
AGCTCGGCTCA -> GCTCGGCTCAC
AGCTCTCAGCG -> GCTCTCAGCGC
AGCTGACACAT -> GCTGACACATG
AGCTTCCGAAG -> GCTTCCGAAGA
AGCTTCCGTGC -> GCTTCCGTGCG
AGGAACCTAAC -> GGAACCTAACC
AGGACGCAGGA -> GGACGCAGGAG
AGGACGCGGTT -> GGACGCGGTTG
AGGACGGAATG -> GGACGGAATGG
AGGAGACGATT -> GGAGACGATTA
AGGAGCTCCTC -> GGAGCTCCTCG
AGGAGCTCTCA -> GGAGCTCTCAG
AGGAGTGGCGT -> GGAGTGGCGTT
AGGCCGGGAAC -> GGCCGGGAACC
AGGCGCATGAT -> GGCGCATGATT
AGGCTACCTTT -> GGCTACCTTTC
AGGGAGACTGA -> GGGAGACTGAT
AGGGATGTTAC -> GGGATGTTACA
AGGGCCGCCAG -> GGGCCGCCAGC
AGGGCTCCGGG -> GGGCTCCGGGA
AGGTACGCTAC -> GGTACGCTACT
AGGTAGCTATT -> GGTAGCTATTA
AGGTCCTTGAC -> GGTCCTTGACG
AGGTGAGAGCT -> GGTGAGAGCTT
AGGTGGAACTG -> GGTGGAACTGT
AGGTTACTTCT -> GGTTACTTCTG
AGGTTCGCGGA -> GGTTCGCGGAG
AGGTTGAGGTA -> GGTTGAGGTAG
AGGTTTAGATG -> GGTTTAGATGA
AGTAAGCCTCA -> GTAAGCCTCAT
AGTACAGACGC -> GTACAGACGCG
AGTACGGATGT -> GTACGGATGTA
AGTACGTTCCG -> GTACGTTCCGG
AGTACTCGAAG -> GTACTCGAAGG
AGTAGACATCC -> GTAGACATCCA
AGTAGCGTGTG -> GTAGCGTGTGC
AGTAGGTTCGC -> GTAGGTTCGCG
AGTATCCTGCT -> GTATCCTGCTT
AGTATGGCAAG -> GTATGGCAAGT
AGTATTTCTTG -> GTATTTCTTGG
AGTCACCACTC -> GTCACCACTCT
AGTCATTAGCG -> GTCATTAGCGC
AGTCCGGCCCA -> GTCCGGCCCAG
AGTCGACCCTT -> GTCGACCCTTC
AGTCGATAGCC -> GTCGATAGCCT
AGTCTAGGAGC -> GTCTAGGAGCT
AGTCTCCTTAG -> GTCTCCTTAGT
AGTGAATTCCT -> GTGAATTCCTC
AGTGAGTGTGG -> GTGAGTGTGGA
AGTGCACGCGC -> GTGCACGCGCT
AGTGCAGTACA -> GTGCAGTACAG
AGTGGCGTTAG -> GTGGCGTTAGA
AGTGTGGAGGT -> GTGTGGAGGTA
AGTTACTACGT -> GTTACTACGTG
AGTTCTACCCT -> GTTCTACCCTA
AGTTCTCATGG -> GTTCTCATGGA
AGTTGTCGCAG -> GTTGTCGCAGT
AGTTTTCACCG -> GTTTTCACCGG
ATAAAGACGCA -> TAAAGACGCAC
ATAAAGTTACT -> TAAAGTTACTA
ATAACATTACT -> TAACATTACTT
ATAAGGTCCTT -> TAAGGTCCTTG
ATACAAGTGAA -> TACAAGTGAAT
ATACAATAGCA -> TACAATAGCAT
ATACATGTTAA -> TACATGTTAAA
ATACCTAAGAG -> TACCTAAGAGC
ATACGAGTACG -> TACGAGTACGT
ATACGCTGTCC -> TACGCTGTCCA
ATAGCATCCCC -> TAGCATCCCCT
ATAGCATCTCC -> TAGCATCTCCG
ATAGCATTGTT -> TAGCATTGTTT
ATAGCCTTCGG -> TAGCCTTCGGA
ATAGCTGACAC -> TAGCTGACACA
ATAGGGCTCCG -> TAGGGCTCCGG
ATAGTAAGCCT -> TAGTAAGCCTC
ATATAGCATTG -> TATAGCATTGT
ATATCGGGAAG -> TATCGGGAAGC
ATATGGAGGAG -> TATGGAGGAGA
ATATGGTACGC -> TATGGTACGCC
ATATGTTCATG -> TATGTTCATGT
ATATTCGACCA -> TATTCGACCAT
ATATTGGGGGA -> TATTGGGGGAG
ATATTTTGGGC -> TATTTTGGGCA
ATCAATTCACA -> TCAATTCACAC
ATCACGTACTA -> TCACGTACTAG
ATCACTCATGT -> TCACTCATGTT
ATCATACGAGT -> TCATACGAGTA
ATCATGATCAA -> TCATGATCAAT
ATCATGATCCC -> TCATGATCCCC
ATCATTACACA -> TCATTACACAC
ATCCAACACTA -> TCCAACACTAC
ATCCACACCTA -> TCCACACCTAT
ATCCACTACCG -> TCCACTACCGT
ATCCATAAAGA -> TCCATAAAGAC
ATCCCCGCGGG -> TCCCCGCGGGT
ATCCCCTGCGC -> TCCCCTGCGCT
ATCCTGCTTAC -> TCCTGCTTACG
ATCCTGTGCCA -> TCCTGTGCCAC
ATCGCGTGACG -> TCGCGTGACGC
ATCGGATCTAT -> TCGGATCTATC
ATCGGCGCTTG -> TCGGCGCTTGA
ATCGGGAAGCT -> TCGGGAAGCTT
ATCGGGGTAGG -> TCGGGGTAGGA
ATCTATCACGT -> TCTATCACGTA
ATCTCCGAACA -> TCTCCGAACAT
ATCTCTCGCTT -> TCTCTCGCTTG
ATCTTACTACT -> TCTTACTACTT
ATCTTACTGAC -> TCTTACTGACT
ATCTTTATGAT -> TCTTTATGATC
ATGAAGCATTT -> TGAAGCATTTG
ATGAATATGGA -> TGAATATGGAG
ATGACCGATCT -> TGACCGATCTT
ATGACTATCTT -> TGACTATCTTA
ATGAGAAGGTG -> TGAGAAGGTGG
ATGAGACGTTA -> TGAGACGTTAG
ATGAGCTCGGC -> TGAGCTCGGCT
ATGATCAATTC -> TGATCAATTCA
ATGATCCCCGC -> TGATCCCCGCG
ATGATCGGATC -> TGATCGGATCT
ATGATCTCTCG -> TGATCTCTCGC
ATGATTCGGCC -> TGATTCGGCCA
ATGCATATCGG -> TGCATATCGGG
ATGCCAGGACG -> TGCCAGGACGC
ATGCCCACAGT -> TGCCCACAGTA
ATGCCTCGACC -> TGCCTCGACCT
ATGCTGCGTGA -> TGCTGCGTGAG
ATGCTGGCTCC -> TGCTGGCTCCT
ATGGAGGAGAC -> TGGAGGAGACG
ATGGCAAGTCG -> TGGCAAGTCGA
ATGGCCACAAT -> TGGCCACAATA
ATGGCCTGCGC -> TGGCCTGCGCG
ATGGCGTGGCG -> TGGCGTGGCGC
ATGGCTGGCAC -> TGGCTGGCACT
ATGGGCAATCG -> TGGGCAATCGG
ATGGGCTCATG -> TGGGCTCATGG
ATGGGGTACAT -> TGGGGTACATA
ATGGTACGCCG -> TGGTACGCCGC
ATGGTGAAACG -> TGGTGAAACGT
ATGGTTCATGT -> TGGTTCATGTA
ATGTAACATAA -> TGTAACATAAG
ATGTAATAAAG -> TGTAATAAAGT
ATGTAGATACG -> TGTAGATACGC
ATGTAGCCCAA -> TGTAGCCCAAG
ATGTATTGCTT -> TGTATTGCTTG
ATGTCGGATAA -> TGTCGGATAAC
ATGTGAGGTGA -> TGTGAGGTGAG
ATGTGAGTGAG -> TGTGAGTGAGT
ATGTGTGTTAT -> TGTGTGTTATT
ATGTTAAACAA -> TGTTAAACAAA
ATGTTACATCA -> TGTTACATCAT
ATGTTAGATAT -> TGTTAGATATA
ATGTTCATGTG -> TGTTCATGTGA
ATGTTCGGTTA -> TGTTCGGTTAG
ATGTTCGTCGA -> TGTTCGTCGAA
ATTAACCAAGT -> TTAACCAAGTG
ATTAAGGCCGG -> TTAAGGCCGGG
ATTAATTCAGT -> TTAATTCAGTG
ATTACACACAG -> TTACACACAGG
ATTACTTTTTC -> TTACTTTTTCT
ATTAGCGCTAA -> TTAGCGCTAAC
ATTATAGTAAG -> TTATAGTAAGC
ATTCACACCAT -> TTCACACCATA
ATTCAGTGCAC -> TTCAGTGCACG
ATTCCTCATGG -> TTCCTCATGGC
ATTCGACCATT -> TTCGACCATTG
ATTCGCCGTTA -> TTCGCCGTTAG
ATTCGGCCATT -> TTCGGCCATTG
ATTCTGGACGT -> TTCTGGACGTG
ATTGACACTTT -> TTGACACTTTT
ATTGCAGTAGG -> TTGCAGTAGGT
ATTGCTATGAG -> TTGCTATGAGC
ATTGCTTGCGC -> TTGCTTGCGCA
ATTGCTTGTCC -> TTGCTTGTCCG
ATTGGCTCACT -> TTGGCTCACTA
ATTGGGGGAGG -> TTGGGGGAGGA
ATTGTTTGCGC -> TTGTTTGCGCA
ATTTCGGCTTC -> TTTCGGCTTCA
ATTTCTTGGCA -> TTTCTTGGCAC
ATTTGCTTGCT -> TTTGCTTGCTA
ATTTTCGGGGA -> TTTTCGGGGAT
ATTTTGGGCAA -> TTTTGGGCAAC
CAAACCCAACT -> AAACCCAACTA
CAAAGTCTCCT -> AAAGTCTCCTT
CAAATGTCGGA -> AAATGTCGGAT
CAACAACCGCT -> AACAACCGCTG
CAACACTACTA -> AACACTACTAC
CAACCATGTTA -> AACCATGTTAG
CAACCCACGCG -> AACCCACGCGC
CAACCGCTGCC -> AACCGCTGCCG
CAACGAAATGG -> AACGAAATGGC
CAACGACTTAA -> AACGACTTAAG
CAACGTCGTTA -> AACGTCGTTAG
CAACTACGAAT -> AACTACGAATG
CAAGAAGCATG -> AAGAAGCATGC
CAAGATAGCAT -> AAGATAGCATC
CAAGCTACGGG -> AAGCTACGGGT
CAAGTCGATAG -> AAGTCGATAGC
CAAGTGAATTC -> AAGTGAATTCC
CAAGTGCAGTA -> AAGTGCAGTAC
CAATACCTAAG -> AATACCTAAGA
CAATAGCATCT -> AATAGCATCTC
CAATCGGGGTA -> AATCGGGGTAG
CAATGTAATAA -> AATGTAATAAA
CAATTCACACC -> AATTCACACCA
CACAAATGTCG -> ACAAATGTCGG
CACAATACCTA -> ACAATACCTAA
CACACAAATGT -> ACACAAATGTC
CACACAGGTTA -> ACACAGGTTAC
CACACCATATT -> ACACCATATTC
CACACCTATGA -> ACACCTATGAA
CACAGCCGGAC -> ACAGCCGGACG
CACAGGTTACT -> ACAGGTTACTT
CACAGGTTTAG -> ACAGGTTTAGA
CACAGTACGGA -> ACAGTACGGAT
CACATGTAGCC -> ACATGTAGCCC
CACCAAGATAG -> ACCAAGATAGC
CACCACTCTCC -> ACCACTCTCCT
CACCATATTCG -> ACCATATTCGA
CACCATGAGAC -> ACCATGAGACG
CACCGGTCATG -> ACCGGTCATGC
CACCGGTTCTT -> ACCGGTTCTTT
CACCTATGAAT -> ACCTATGAATA
CACGCCGCAGC -> ACGCCGCAGCC
CACGCCTGAAT -> ACGCCTGAATC
CACGCGCTACG -> ACGCGCTACGT
CACGCGCTGGT -> ACGCGCTGGTT
CACGGACCGAA -> ACGGACCGAAG
CACGGTCCATA -> ACGGTCCATAG
CACGTACTAGC -> ACGTACTAGCC
CACGTATATTT -> ACGTATATTTT
CACTACCGTGA -> ACTACCGTGAT
CACTACGACCG -> ACTACGACCGC
CACTACTACCT -> ACTACTACCTT
CACTCATGTTC -> ACTCATGTTCG
CACTCTCCTTG -> ACTCTCCTTGC
CACTGCTGTTG -> ACTGCTGTTGC
CACTTACGGAC -> ACTTACGGACG
CACTTTTCGAC -> ACTTTTCGACC
CAGACCATCAT -> AGACCATCATA
CAGACGCGAAT -> AGACGCGAATT
CAGAGATGGCT -> AGAGATGGCTG
CAGATGGGGTA -> AGATGGGGTAC
CAGCACAGGTT -> AGCACAGGTTT
CAGCCAGCGGG -> AGCCAGCGGGG
CAGCCGGACGT -> AGCCGGACGTA
CAGCCGTCAGT -> AGCCGTCAGTC
CAGCGCGACTC -> AGCGCGACTCT
CAGCGGGGCGG -> AGCGGGGCGGA
CAGGACGCGGT -> AGGACGCGGTT
CAGGAGTGGCG -> AGGAGTGGCGT
CAGGCTACCTT -> AGGCTACCTTT
CAGGTTACTTC -> AGGTTACTTCT
CAGGTTTAGAT -> AGGTTTAGATG
CAGTACAGACG -> AGTACAGACGC
CAGTACGGATG -> AGTACGGATGT
CAGTAGGTTCG -> AGTAGGTTCGC
CAGTATTTCTT -> AGTATTTCTTG
CAGTCCGGCCC -> AGTCCGGCCCA
CAGTGCACGCG -> AGTGCACGCGC
CAGTTCTACCC -> AGTTCTACCCT
CATAAAGACGC -> ATAAAGACGCA
CATAAGGTCCT -> ATAAGGTCCTT
CATACGAGTAC -> ATACGAGTACG
CATAGGGCTCC -> ATAGGGCTCCG
CATATCGGGAA -> ATATCGGGAAG
CATATGGTACG -> ATATGGTACGC
CATATTCGACC -> ATATTCGACCA
CATCACTCATG -> ATCACTCATGT
CATCATACGAG -> ATCATACGAGT
CATCATGATCA -> ATCATGATCAA
CATCCAACACT -> ATCCAACACTA
CATCCACACCT -> ATCCACACCTA
CATCCACTACC -> ATCCACTACCG
CATCCATAAAG -> ATCCATAAAGA
CATCCCCTGCG -> ATCCCCTGCGC
CATCCTGTGCC -> ATCCTGTGCCA
CATCGGCGCTT -> ATCGGCGCTTG
CATCTCCGAAC -> ATCTCCGAACA
CATGACTATCT -> ATGACTATCTT
CATGAGACGTT -> ATGAGACGTTA
CATGATCAATT -> ATGATCAATTC
CATGATCCCCG -> ATGATCCCCGC
CATGATCGGAT -> ATGATCGGATC
CATGATTCGGC -> ATGATTCGGCC
CATGCATATCG -> ATGCATATCGG
CATGCCCACAG -> ATGCCCACAGT
CATGCCTCGAC -> ATGCCTCGACC
CATGCTGGCTC -> ATGCTGGCTCC
CATGGCCACAA -> ATGGCCACAAT
CATGGCCTGCG -> ATGGCCTGCGC
CATGGGCAATC -> ATGGGCAATCG
CATGTAGCCCA -> ATGTAGCCCAA
CATGTATTGCT -> ATGTATTGCTT
CATGTGAGGTG -> ATGTGAGGTGA
CATGTTAAACA -> ATGTTAAACAA
CATGTTAGATA -> ATGTTAGATAT
CATGTTCGGTT -> ATGTTCGGTTA
CATTACACACA -> ATTACACACAG
CATTACTTTTT -> ATTACTTTTTC
CATTAGCGCTA -> ATTAGCGCTAA
CATTCGCCGTT -> ATTCGCCGTTA
CATTGCTATGA -> ATTGCTATGAG
CATTGCTTGCG -> ATTGCTTGCGC
CATTGGCTCAC -> ATTGGCTCACT
CATTGTTTGCG -> ATTGTTTGCGC
CATTTGCTTGC -> ATTTGCTTGCT
CCAACACTACT -> CAACACTACTA
CCAACTACGAA -> CAACTACGAAT
CCAAGAAGCAT -> CAAGAAGCATG
CCAAGATAGCA -> CAAGATAGCAT
CCAAGTGCAGT -> CAAGTGCAGTA
CCAATGTAATA -> CAATGTAATAA
CCACAATACCT -> CACAATACCTA
CCACACCTATG -> CACACCTATGA
CCACAGTACGG -> CACAGTACGGA
CCACCATGAGA -> CACCATGAGAC
CCACGCGCTAC -> CACGCGCTACG
CCACTACCGTG -> CACTACCGTGA
CCACTCTCCTT -> CACTCTCCTTG
CCAGCCGTCAG -> CAGCCGTCAGT
CCAGCGGGGCG -> CAGCGGGGCGG
CCAGGACGCGG -> CAGGACGCGGT
CCAGGCTACCT -> CAGGCTACCTT
CCAGTATTTCT -> CAGTATTTCTT
CCATAAAGACG -> CATAAAGACGC
CCATAGGGCTC -> CATAGGGCTCC
CCATATTCGAC -> CATATTCGACC
CCATCACTCAT -> CATCACTCATG
CCATCATACGA -> CATCATACGAG
CCATCCTGTGC -> CATCCTGTGCC
CCATGAGACGT -> CATGAGACGTT
CCATGCCTCGA -> CATGCCTCGAC
CCATGCTGGCT -> CATGCTGGCTC
CCATGTTAGAT -> CATGTTAGATA
CCATTGCTATG -> CATTGCTATGA
CCATTGGCTCA -> CATTGGCTCAC
CCCAACTACGA -> CCAACTACGAA
CCCAAGAAGCA -> CCAAGAAGCAT
CCCAATGTAAT -> CCAATGTAATA
CCCACAGTACG -> CCACAGTACGG
CCCACGCGCTA -> CCACGCGCTAC
CCCAGGCTACC -> CCAGGCTACCT
CCCATCCTGTG -> CCATCCTGTGC
CCCCATCCTGT -> CCCATCCTGTG
CCCCGCGGGTG -> CCCGCGGGTGT
CCCCTGCGCTG -> CCCTGCGCTGA
CCCGCCATCAC -> CCGCCATCACT
CCCGCGGGTGT -> CCGCGGGTGTT
CCCGGGCTCGT -> CCGGGCTCGTT
CCCGTCATGGG -> CCGTCATGGGC
CCCTAGCCGGA -> CCTAGCCGGAC
CCCTGCGCTGA -> CCTGCGCTGAT
CCCTGGACCGA -> CCTGGACCGAT
CCCTGGTATCG -> CCTGGTATCGC
CCCTTCACGCC -> CCTTCACGCCG
CCGAACATCCA -> CGAACATCCAA
CCGAAGAATAT -> CGAAGAATATG
CCGAAGAGATG -> CGAAGAGATGA
CCGATCTTACT -> CGATCTTACTA
CCGATTTTCGG -> CGATTTTCGGG
CCGCAAACCCA -> CGCAAACCCAA
CCGCAGCCAGC -> CGCAGCCAGCG
CCGCCAGCCGT -> CGCCAGCCGTC
CCGCCATCACT -> CGCCATCACTC
CCGCCCGTCAT -> CGCCCGTCATG
CCGCGGGTGTT -> CGCGGGTGTTT
CCGCTGCCGTT -> CGCTGCCGTTA
CCGCTGCGTTA -> CGCTGCGTTAG
CCGCTGGACTC -> CGCTGGACTCT
CCGCTGTAGGG -> CGCTGTAGGGC
CCGGACGTACG -> CGGACGTACGG
CCGGACGTAGT -> CGGACGTAGTC
CCGGCCCAGGC -> CGGCCCAGGCT
CCGGCGCTGGT -> CGGCGCTGGTG
CCGGGAACCTG -> CGGGAACCTGC
CCGGGACCAGT -> CGGGACCAGTA
CCGGGCTCGTT -> CGGGCTCGTTA
CCGGTCATGCA -> CGGTCATGCAT
CCGGTGTTGCA -> CGGTGTTGCAG
CCGGTTCTTTA -> CGGTTCTTTAA
CCGTATTCTGG -> CGTATTCTGGA
CCGTCAGTCCG -> CGTCAGTCCGG
CCGTCATGGGC -> CGTCATGGGCA
CCGTGATGTGA -> CGTGATGTGAG
CCGTGCGTTAT -> CGTGCGTTATC
CCGTTAGGACG -> CGTTAGGACGG
CCGTTAGTCTA -> CGTTAGTCTAG
CCTAACCCCAT -> CTAACCCCATC
CCTAAGAGCAC -> CTAAGAGCACG
CCTAGCCGGAC -> CTAGCCGGACG
CCTATAGCTGA -> CTATAGCTGAC
CCTATGAATAT -> CTATGAATATG
CCTCATGACTA -> CTCATGACTAT
CCTCATGGCCA -> CTCATGGCCAC
CCTCCTTGCAT -> CTCCTTGCATC
CCTCGACCTTG -> CTCGACCTTGC
CCTCGTTGAAG -> CTCGTTGAAGT
CCTGAATCTTT -> CTGAATCTTTA
CCTGCGCGCCT -> CTGCGCGCCTC
CCTGCGCTGAT -> CTGCGCTGATA
CCTGCGGCCCG -> CTGCGGCCCGC
CCTGCTTACGC -> CTGCTTACGCC
CCTGGACCGAT -> CTGGACCGATT
CCTGGTATCGC -> CTGGTATCGCG
CCTGTAAGGCG -> CTGTAAGGCGC
CCTGTGCCACC -> CTGTGCCACCA
CCTTAGTATCC -> CTTAGTATCCT
CCTTCACGCCG -> CTTCACGCCGC
CCTTCACTTAC -> CTTCACTTACG
CCTTCATGATC -> CTTCATGATCG
CCTTCGGACTT -> CTTCGGACTTA
CCTTGACGCCG -> CTTGACGCCGG
CCTTGATGTGT -> CTTGATGTGTG
CCTTGCATCCA -> CTTGCATCCAT
CCTTGCGCGAC -> CTTGCGCGACG
CCTTGCGTAAC -> CTTGCGTAACG
CCTTTCAACCC -> CTTTCAACCCA
CGAAATGCTGC -> GAAATGCTGCG
CGAAATGGCGT -> GAAATGGCGTG
CGAACATCCAA -> GAACATCCAAC
CGAAGAATATG -> GAAGAATATGT
CGAAGAGATGA -> GAAGAGATGAC
CGAAGGACGCA -> GAAGGACGCAG
CGAATGTTCGT -> GAATGTTCGTC
CGAATTAAGGC -> GAATTAAGGCC
CGACCATTGGC -> GACCATTGGCT
CGACCCTTCAC -> GACCCTTCACG
CGACCGCTGGA -> GACCGCTGGAC
CGACCTGTAAG -> GACCTGTAAGG
CGACCTTGCGC -> GACCTTGCGCG
CGACGTCCATG -> GACGTCCATGC
CGACTCTCGTT -> GACTCTCGTTA
CGACTTAAGAC -> GACTTAAGACT
CGAGACCTTCA -> GAGACCTTCAT
CGAGTACGTTC -> GAGTACGTTCC
CGAGTAGACAT -> GAGTAGACATC
CGATAGCCTTC -> GATAGCCTTCG
CGATCTTACTA -> GATCTTACTAC
CGATGTAGATA -> GATGTAGATAC
CGATTAACCAA -> GATTAACCAAG
CGATTTTCGGG -> GATTTTCGGGG
CGCAAACCCAA -> GCAAACCCAAC
CGCAACCATGT -> GCAACCATGTT
CGCAAGCTACG -> GCAAGCTACGG
CGCACGTATAT -> GCACGTATATT
CGCAGCACAGG -> GCAGCACAGGT
CGCAGCCAGCG -> GCAGCCAGCGG
CGCAGGAGTGG -> GCAGGAGTGGC
CGCAGTTCTAC -> GCAGTTCTACC
CGCATGATTCG -> GCATGATTCGG
CGCCAGCCGTC -> GCCAGCCGTCA
CGCCATCACTC -> GCCATCACTCA
CGCCCGTCATG -> GCCCGTCATGG
CGCCGCAGCCA -> GCCGCAGCCAG
CGCCGCCCGTC -> GCCGCCCGTCA
CGCCGCTGTAG -> GCCGCTGTAGG
CGCCGGTGTTG -> GCCGGTGTTGC
CGCCGTATTCT -> GCCGTATTCTG
CGCCGTTAGGA -> GCCGTTAGGAC
CGCCTCCTTGC -> GCCTCCTTGCA
CGCCTGAATCT -> GCCTGAATCTT
CGCGAATTAAG -> GCGAATTAAGG
CGCGACGTCCA -> GCGACGTCCAT
CGCGACTCTCG -> GCGACTCTCGT
CGCGCCTCCTT -> GCGCCTCCTTG
CGCGCTACGTA -> GCGCTACGTAC
CGCGCTGGGAG -> GCGCTGGGAGA
CGCGCTGGTTT -> GCGCTGGTTTA
CGCGGAGTAGC -> GCGGAGTAGCG
CGCGGCTGGGG -> GCGGCTGGGGG
CGCGGGTGTTT -> GCGGGTGTTTA
CGCGGTTGCCT -> GCGGTTGCCTA
CGCGTGACGCG -> GCGTGACGCGC
CGCTAACAACG -> GCTAACAACGA
CGCTACGTACA -> GCTACGTACAC
CGCTACTTGGA -> GCTACTTGGAC
CGCTGATACAA -> GCTGATACAAG
CGCTGCCGTTA -> GCTGCCGTTAG
CGCTGCGTTAG -> GCTGCGTTAGT
CGCTGGACTCT -> GCTGGACTCTG
CGCTGGGAGAG -> GCTGGGAGAGG
CGCTGGTGCGA -> GCTGGTGCGAG
CGCTGGTTTAC -> GCTGGTTTACC
CGCTGTAGGGC -> GCTGTAGGGCC
CGCTGTCCATG -> GCTGTCCATGC
CGCTTGATCAT -> GCTTGATCATG
CGCTTGCTCGT -> GCTTGCTCGTA
CGGAATACAAT -> GGAATACAATA
CGGAATGGTTC -> GGAATGGTTCA
CGGACCGAAGA -> GGACCGAAGAA
CGGACGAGACC -> GGACGAGACCT
CGGACGTACGG -> GGACGTACGGG
CGGACGTAGTC -> GGACGTAGTCG
CGGACTTACGT -> GGACTTACGTA
CGGAGTAGCGT -> GGAGTAGCGTG
CGGATAACATT -> GGATAACATTA
CGGATCTATCA -> GGATCTATCAC
CGGATGTAACA -> GGATGTAACAT
CGGCCATTGCT -> GGCCATTGCTA
CGGCCCAGGCT -> GGCCCAGGCTA
CGGCCCGCCAT -> GGCCCGCCATC
CGGCGCTGGTG -> GGCGCTGGTGC
CGGCGCTTGAT -> GGCGCTTGATC
CGGCTCAACGT -> GGCTCAACGTC
CGGCTCACGGT -> GGCTCACGGTC
CGGCTGGGGGT -> GGCTGGGGGTG
CGGCTTCATTG -> GGCTTCATTGC
CGGGAACCTGC -> GGGAACCTGCG
CGGGAAGCTTC -> GGGAAGCTTCC
CGGGACCAGTA -> GGGACCAGTAT
CGGGCAACGAC -> GGGCAACGACT
CGGGCTCGTTA -> GGGCTCGTTAC
CGGGGATACAT -> GGGGATACATG
CGGGGCGGAAT -> GGGGCGGAATA
CGGGGTAGGAA -> GGGGTAGGAAC
CGGGTCTAGGG -> GGGTCTAGGGA
CGGGTGTTTAA -> GGGTGTTTAAG
CGGTCATGCAT -> GGTCATGCATA
CGGTCCATAGG -> GGTCCATAGGG
CGGTCGATGTA -> GGTCGATGTAG
CGGTGAGTACT -> GGTGAGTACTC
CGGTGTTGCAG -> GGTGTTGCAGA
CGGTTAGCCCT -> GGTTAGCCCTG
CGGTTCTTTAA -> GGTTCTTTAAA
CGGTTGCCTAT -> GGTTGCCTATA
CGTAACGTACA -> GTAACGTACAC
CGTAAGTTTTC -> GTAAGTTTTCA
CGTACACACAA -> GTACACACAAA
CGTACACGCCT -> GTACACGCCTG
CGTACGGGCAA -> GTACGGGCAAC
CGTACTAGCCC -> GTACTAGCCCT
CGTAGCGCAAC -> GTAGCGCAACC
CGTAGTCGACC -> GTAGTCGACCC
CGTATATTTTG -> GTATATTTTGG
CGTATTCTGGA -> GTATTCTGGAC
CGTCAGATGGG -> GTCAGATGGGG
CGTCAGTCCGG -> GTCAGTCCGGC
CGTCATCGGCG -> GTCATCGGCGC
CGTCATGGGCA -> GTCATGGGCAA
CGTCCATGCTG -> GTCCATGCTGG
CGTCGAAATGC -> GTCGAAATGCT
CGTCGTTAGAT -> GTCGTTAGATT
CGTGACGCGCT -> GTGACGCGCTG
CGTGAGGGATG -> GTGAGGGATGT
CGTGATGTGAG -> GTGATGTGAGT
CGTGCGTTATC -> GTGCGTTATCA
CGTGCTAACAT -> GTGCTAACATC
CGTGCTAGAGT -> GTGCTAGAGTT
CGTGGCGCCGT -> GTGGCGCCGTA
CGTGTGCGCGG -> GTGTGCGCGGC
CGTTACACCAA -> GTTACACCAAG
CGTTACATTCG -> GTTACATTCGC
CGTTAGATTAT -> GTTAGATTATA
CGTTAGATTGC -> GTTAGATTGCA
CGTTAGGACGG -> GTTAGGACGGA
CGTTAGTATGG -> GTTAGTATGGC
CGTTAGTCTAG -> GTTAGTCTAGG
CGTTAGTTCTC -> GTTAGTTCTCA
CGTTATCATTA -> GTTATCATTAC
CGTTCCGGCGC -> GTTCCGGCGCT
CGTTGAAGTCA -> GTTGAAGTCAC
CGTTGTTAATG -> GTTGTTAATGG
CTAAATGAGAA -> TAAATGAGAAG
CTAACAACGAA -> TAACAACGAAA
CTAACATCCAC -> TAACATCCACA
CTAACCCCATC -> TAACCCCATCC
CTAAGAGCACG -> TAAGAGCACGG
CTAAGCGTCAT -> TAAGCGTCATC
CTACCCTAGCC -> TACCCTAGCCG
CTACCGTGATG -> TACCGTGATGT
CTACCTTCACT -> TACCTTCACTT
CTACCTTTCAA -> TACCTTTCAAC
CTACGAATGTT -> TACGAATGTTC
CTACGACCGCT -> TACGACCGCTG
CTACGGGTCTA -> TACGGGTCTAG
CTACGTACACA -> TACGTACACAC
CTACGTGCTAG -> TACGTGCTAGA
CTACTACCTTC -> TACTACCTTCA
CTACTTACCGC -> TACTTACCGCT
CTACTTGGACT -> TACTTGGACTC
CTAGAGTTGTC -> TAGAGTTGTCG
CTAGCCCTGGA -> TAGCCCTGGAC
CTAGCCGGACG -> TAGCCGGACGT
CTAGGAGCTCT -> TAGGAGCTCTC
CTAGGGAGACT -> TAGGGAGACTG
CTATAGCTGAC -> TATAGCTGACA
CTATCACGTAC -> TATCACGTACT
CTATCTTACTG -> TATCTTACTGA
CTATGAATATG -> TATGAATATGG
CTATGAGCTCG -> TATGAGCTCGG
CTATGGGCTCA -> TATGGGCTCAT
CTATTAATTCA -> TATTAATTCAG
CTCAACGTCGT -> TCAACGTCGTT
CTCACGGTCCA -> TCACGGTCCAT
CTCACTACGAC -> TCACTACGACC
CTCAGCGCGAC -> TCAGCGCGACT
CTCATGACTAT -> TCATGACTATC
CTCATGGCCAC -> TCATGGCCACA
CTCATGGCCTG -> TCATGGCCTGC
CTCATGTTCGG -> TCATGTTCGGT
CTCCGAACATC -> TCCGAACATCC
CTCCGGGACCA -> TCCGGGACCAG
CTCCTCGTTGA -> TCCTCGTTGAA
CTCCTTAGTAT -> TCCTTAGTATC
CTCCTTGATGT -> TCCTTGATGTG
CTCCTTGCATC -> TCCTTGCATCC
CTCCTTGCGTA -> TCCTTGCGTAA
CTCGAAGGACG -> TCGAAGGACGC
CTCGACCTTGC -> TCGACCTTGCG
CTCGCTTGCTC -> TCGCTTGCTCG
CTCGGCTCACG -> TCGGCTCACGG
CTCGTAAGTTT -> TCGTAAGTTTT
CTCGTTACACC -> TCGTTACACCA
CTCGTTACATT -> TCGTTACATTC
CTCGTTGAAGT -> TCGTTGAAGTC
CTCTCAGCGCG -> TCTCAGCGCGA
CTCTCCTTGCG -> TCTCCTTGCGT
CTCTCGCTTGC -> TCTCGCTTGCT
CTCTCGTTACA -> TCTCGTTACAC
CTCTGGTTTCG -> TCTGGTTTCGG
CTCTTATATTG -> TCTTATATTGG
CTCTTGTGTTT -> TCTTGTGTTTT
CTGAATCTTTA -> TGAATCTTTAT
CTGAATTTCGG -> TGAATTTCGGC
CTGACACATGT -> TGACACATGTA
CTGACTCTTGT -> TGACTCTTGTG
CTGATACAAGT -> TGATACAAGTG
CTGATGCCAGG -> TGATGCCAGGA
CTGCCGTTAGT -> TGCCGTTAGTC
CTGCGCGCCTC -> TGCGCGCCTCC
CTGCGCTGATA -> TGCGCTGATAC
CTGCGGCCCGC -> TGCGGCCCGCC
CTGCGTGAGGG -> TGCGTGAGGGA
CTGCGTTAGTT -> TGCGTTAGTTC
CTGCTGTTGCA -> TGCTGTTGCAG
CTGCTTACGCC -> TGCTTACGCCG
CTGGACCGATT -> TGGACCGATTT
CTGGACGTGCT -> TGGACGTGCTA
CTGGACTCTGG -> TGGACTCTGGT
CTGGCACTGCT -> TGGCACTGCTG
CTGGCTCCTTG -> TGGCTCCTTGA
CTGGGAGAGGT -> TGGGAGAGGTT
CTGGGGGTGCC -> TGGGGGTGCCC
CTGGTATCGCG -> TGGTATCGCGT
CTGGTGCGAGT -> TGGTGCGAGTA
CTGGTTTACCC -> TGGTTTACCCA
CTGGTTTCGGT -> TGGTTTCGGTC
CTGTAAGGCGC -> TGTAAGGCGCA
CTGTAGGGCCG -> TGTAGGGCCGC
CTGTCCATGCC -> TGTCCATGCCT
CTGTGAAACAC -> TGTGAAACACC
CTGTGCCACCA -> TGTGCCACCAT
CTGTTGCAGAC -> TGTTGCAGACC
CTTAAGACTTC -> TTAAGACTTCG
CTTACCGCTGC -> TTACCGCTGCG
CTTACGCCGCC -> TTACGCCGCCC
CTTACGGACGA -> TTACGGACGAG
CTTACGTAGCG -> TTACGTAGCGC
CTTACTACTTA -> TTACTACTTAC
CTTACTGACTC -> TTACTGACTCT
CTTAGTATCCT -> TTAGTATCCTG
CTTATATTGGG -> TTATATTGGGG
CTTCACGCCGC -> TTCACGCCGCA
CTTCACTTACG -> TTCACTTACGG
CTTCATGATCG -> TTCATGATCGG
CTTCATTGCTT -> TTCATTGCTTG
CTTCCGAAGAG -> TTCCGAAGAGA
CTTCCGTGCGT -> TTCCGTGCGTT
CTTCGGACTTA -> TTCGGACTTAC
CTTCGGTGAGT -> TTCGGTGAGTA
CTTCTGAATTT -> TTCTGAATTTC
CTTGACGCCGG -> TTGACGCCGGT
CTTGATCATGA -> TTGATCATGAT
CTTGATGTGTG -> TTGATGTGTGT
CTTGCATCCAT -> TTGCATCCATA
CTTGCGCAAGC -> TTGCGCAAGCT
CTTGCGCGACG -> TTGCGCGACGT
CTTGCGTAACG -> TTGCGTAACGT
CTTGCTAAATG -> TTGCTAAATGA
CTTGCTCGTAA -> TTGCTCGTAAG
CTTGGACTCTT -> TTGGACTCTTA
CTTGGCACAGC -> TTGGCACAGCC
CTTGTCCGCAA -> TTGTCCGCAAA
CTTGTGTTTTC -> TTGTGTTTTCG
CTTTAAAAAAG -> TTTAAAAAAGT
CTTTATGATCT -> TTTATGATCTC
CTTTCAACCCA -> TTTCAACCCAC
CTTTTCGACCT -> TTTTCGACCTG
CTTTTTCTAAG -> TTTTTCTAAGC
GAAACACCGGT -> AAACACCGGTC
GAAACGTCAGA -> AAACGTCAGAT
GAAATGCTGCG -> AAATGCTGCGT
GAAATGGCGTG -> AAATGGCGTGG
GAACATCCAAC -> AACATCCAACA
GAACCTAACCC -> AACCTAACCCC
GAACCTGCGGC -> AACCTGCGGCC
GAACTGTGAAA -> AACTGTGAAAC
GAAGAATATGT -> AAGAATATGTT
GAAGAGATGAC -> AAGAGATGACC
GAAGCATGCCC -> AAGCATGCCCA
GAAGCATTTGC -> AAGCATTTGCT
GAAGCTTCCGA -> AAGCTTCCGAA
GAAGGACGCAG -> AAGGACGCAGG
GAAGGTGGAAC -> AAGGTGGAACT
GAAGTCACCAC -> AAGTCACCACT
GAATACAATAG -> AATACAATAGC
GAATATGGAGG -> AATATGGAGGA
GAATATGTTCA -> AATATGTTCAT
GAATCTTTATG -> AATCTTTATGA
GAATGGTTCAT -> AATGGTTCATG
GAATGTTCGTC -> AATGTTCGTCG
GAATTAAGGCC -> AATTAAGGCCG
GAATTCCTCAT -> AATTCCTCATG
GAATTTCGGCT -> AATTTCGGCTT
GACACATGTAG -> ACACATGTAGC
GACACTTTTCG -> ACACTTTTCGA
GACATCCACTA -> ACATCCACTAC
GACCAGTATTT -> ACCAGTATTTC
GACCATCATAC -> ACCATCATACG
GACCATTGGCT -> ACCATTGGCTC
GACCCTTCACG -> ACCCTTCACGC
GACCGAAGAAT -> ACCGAAGAATA
GACCGATCTTA -> ACCGATCTTAC
GACCGATTTTC -> ACCGATTTTCG
GACCGCTGGAC -> ACCGCTGGACT
GACCTGTAAGG -> ACCTGTAAGGC
GACCTTCATGA -> ACCTTCATGAT
GACCTTGCGCG -> ACCTTGCGCGA
GACGAGACCTT -> ACGAGACCTTC
GACGATTAACC -> ACGATTAACCA
GACGCACGTAT -> ACGCACGTATA
GACGCAGGAGT -> ACGCAGGAGTG
GACGCCGGTGT -> ACGCCGGTGTT
GACGCGAATTA -> ACGCGAATTAA
GACGCGCTGGG -> ACGCGCTGGGA
GACGCGGTTGC -> ACGCGGTTGCC
GACGGAATGGT -> ACGGAATGGTT
GACGTACGGGC -> ACGTACGGGCA
GACGTAGTCGA -> ACGTAGTCGAC
GACGTCCATGC -> ACGTCCATGCT
GACGTGCTAAC -> ACGTGCTAACA
GACGTTAGTAT -> ACGTTAGTATG
GACTATCTTAC -> ACTATCTTACT
GACTATGGGCT -> ACTATGGGCTC
GACTCTCGTTA -> ACTCTCGTTAC
GACTCTGGTTT -> ACTCTGGTTTC
GACTCTTATAT -> ACTCTTATATT
GACTCTTGTGT -> ACTCTTGTGTT
GACTGATGCCA -> ACTGATGCCAG
GACTTAAGACT -> ACTTAAGACTT
GACTTACGTAG -> ACTTACGTAGC
GACTTCGGTGA -> ACTTCGGTGAG
GAGAAGGTGGA -> AGAAGGTGGAA
GAGACCTTCAT -> AGACCTTCATG
GAGACGATTAA -> AGACGATTAAC
GAGACGTTAGT -> AGACGTTAGTA
GAGACTGATGC -> AGACTGATGCC
GAGAGCTTCCG -> AGAGCTTCCGT
GAGAGGTTGAG -> AGAGGTTGAGG
GAGATGACCGA -> AGATGACCGAT
GAGATGGCTGG -> AGATGGCTGGC
GAGCACGGACC -> AGCACGGACCG
GAGCTCCTCGT -> AGCTCCTCGTT
GAGCTCGGCTC -> AGCTCGGCTCA
GAGCTCTCAGC -> AGCTCTCAGCG
GAGCTTCCGTG -> AGCTTCCGTGC
GAGGAGACGAT -> AGGAGACGATT
GAGGAGCTCCT -> AGGAGCTCCTC
GAGGGATGTTA -> AGGGATGTTAC
GAGGTACGCTA -> AGGTACGCTAC
GAGGTAGCTAT -> AGGTAGCTATT
GAGGTGAGAGC -> AGGTGAGAGCT
GAGGTTGAGGT -> AGGTTGAGGTA
GAGTACGTTCC -> AGTACGTTCCG
GAGTACTCGAA -> AGTACTCGAAG
GAGTAGACATC -> AGTAGACATCC
GAGTAGCGTGT -> AGTAGCGTGTG
GAGTGAGTGTG -> AGTGAGTGTGG
GAGTGGCGTTA -> AGTGGCGTTAG
GAGTGTGGAGG -> AGTGTGGAGGT
GAGTTGTCGCA -> AGTTGTCGCAG
GATAACATTAC -> ATAACATTACT
GATACAAGTGA -> ATACAAGTGAA
GATACATGTTA -> ATACATGTTAA
GATACGCTGTC -> ATACGCTGTCC
GATAGCATCCC -> ATAGCATCCCC
GATAGCCTTCG -> ATAGCCTTCGG
GATATAGCATT -> ATATAGCATTG
GATCAATTCAC -> ATCAATTCACA
GATCATGATCC -> ATCATGATCCC
GATCCCCGCGG -> ATCCCCGCGGG
GATCGGATCTA -> ATCGGATCTAT
GATCTATCACG -> ATCTATCACGT
GATCTCTCGCT -> ATCTCTCGCTT
GATCTTACTAC -> ATCTTACTACT
GATGAAGCATT -> ATGAAGCATTT
GATGACCGATC -> ATGACCGATCT
GATGCCAGGAC -> ATGCCAGGACG
GATGGCTGGCA -> ATGGCTGGCAC
GATGGGGTACA -> ATGGGGTACAT
GATGTAACATA -> ATGTAACATAA
GATGTAGATAC -> ATGTAGATACG
GATGTGAGTGA -> ATGTGAGTGAG
GATGTGTGTTA -> ATGTGTGTTAT
GATGTTACATC -> ATGTTACATCA
GATTAACCAAG -> ATTAACCAAGT
GATTATAGTAA -> ATTATAGTAAG
GATTCGGCCAT -> ATTCGGCCATT
GATTGCAGTAG -> ATTGCAGTAGG
GATTTTCGGGG -> ATTTTCGGGGA
GCAAACCCAAC -> CAAACCCAACT
GCAACAACCGC -> CAACAACCGCT
GCAACCATGTT -> CAACCATGTTA
GCAACGACTTA -> CAACGACTTAA
GCAAGCTACGG -> CAAGCTACGGG
GCAAGTCGATA -> CAAGTCGATAG
GCAATCGGGGT -> CAATCGGGGTA
GCACAGCCGGA -> CACAGCCGGAC
GCACAGGTTTA -> CACAGGTTTAG
GCACGCGCTGG -> CACGCGCTGGT
GCACGGACCGA -> CACGGACCGAA
GCACGTATATT -> CACGTATATTT
GCACTGCTGTT -> CACTGCTGTTG
GCAGACCATCA -> CAGACCATCAT
GCAGAGATGGC -> CAGAGATGGCT
GCAGCACAGGT -> CAGCACAGGTT
GCAGCCAGCGG -> CAGCCAGCGGG
GCAGGAGTGGC -> CAGGAGTGGCG
GCAGTACAGAC -> CAGTACAGACG
GCAGTAGGTTC -> CAGTAGGTTCG
GCAGTTCTACC -> CAGTTCTACCC
GCATATCGGGA -> CATATCGGGAA
GCATCCATAAA -> CATCCATAAAG
GCATCCCCTGC -> CATCCCCTGCG
GCATCTCCGAA -> CATCTCCGAAC
GCATGATTCGG -> CATGATTCGGC
GCATGCCCACA -> CATGCCCACAG
GCATTGTTTGC -> CATTGTTTGCG
GCATTTGCTTG -> CATTTGCTTGC
GCCACAATACC -> CCACAATACCT
GCCACCATGAG -> CCACCATGAGA
GCCAGCCGTCA -> CCAGCCGTCAG
GCCAGCGGGGC -> CCAGCGGGGCG
GCCAGGACGCG -> CCAGGACGCGG
GCCATCACTCA -> CCATCACTCAT
GCCATTGCTAT -> CCATTGCTATG
GCCCAAGAAGC -> CCCAAGAAGCA
GCCCACAGTAC -> CCCACAGTACG
GCCCAGGCTAC -> CCCAGGCTACC
GCCCGCCATCA -> CCCGCCATCAC
GCCCGGGCTCG -> CCCGGGCTCGT
GCCCGTCATGG -> CCCGTCATGGG
GCCCTGGACCG -> CCCTGGACCGA
GCCCTGGTATC -> CCCTGGTATCG
GCCGCAGCCAG -> CCGCAGCCAGC
GCCGCCAGCCG -> CCGCCAGCCGT
GCCGCCCGTCA -> CCGCCCGTCAT
GCCGCTGTAGG -> CCGCTGTAGGG
GCCGGACGTAC -> CCGGACGTACG
GCCGGACGTAG -> CCGGACGTAGT
GCCGGGAACCT -> CCGGGAACCTG
GCCGGTGTTGC -> CCGGTGTTGCA
GCCGTATTCTG -> CCGTATTCTGG
GCCGTCAGTCC -> CCGTCAGTCCG
GCCGTTAGGAC -> CCGTTAGGACG
GCCGTTAGTCT -> CCGTTAGTCTA
GCCTATAGCTG -> CCTATAGCTGA
GCCTCATGACT -> CCTCATGACTA
GCCTCCTTGCA -> CCTCCTTGCAT
GCCTCGACCTT -> CCTCGACCTTG
GCCTGAATCTT -> CCTGAATCTTT
GCCTGCGCGCC -> CCTGCGCGCCT
GCCTTCGGACT -> CCTTCGGACTT
GCGAATTAAGG -> CGAATTAAGGC
GCGACGTCCAT -> CGACGTCCATG
GCGACTCTCGT -> CGACTCTCGTT
GCGAGTAGACA -> CGAGTAGACAT
GCGCAACCATG -> CGCAACCATGT
GCGCAAGCTAC -> CGCAAGCTACG
GCGCAGCACAG -> CGCAGCACAGG
GCGCATGATTC -> CGCATGATTCG
GCGCCGTATTC -> CGCCGTATTCT
GCGCCTCCTTG -> CGCCTCCTTGC
GCGCGACGTCC -> CGCGACGTCCA
GCGCGACTCTC -> CGCGACTCTCG
GCGCGCCTCCT -> CGCGCCTCCTT
GCGCGGCTGGG -> CGCGGCTGGGG
GCGCTAACAAC -> CGCTAACAACG
GCGCTACGTAC -> CGCTACGTACA
GCGCTGATACA -> CGCTGATACAA
GCGCTGGGAGA -> CGCTGGGAGAG
GCGCTGGTGCG -> CGCTGGTGCGA
GCGCTGGTTTA -> CGCTGGTTTAC
GCGCTTGATCA -> CGCTTGATCAT
GCGGAATACAA -> CGGAATACAAT
GCGGAGTAGCG -> CGGAGTAGCGT
GCGGCCCGCCA -> CGGCCCGCCAT
GCGGCTGGGGG -> CGGCTGGGGGT
GCGGGGCGGAA -> CGGGGCGGAAT
GCGGGTGTTTA -> CGGGTGTTTAA
GCGGTTGCCTA -> CGGTTGCCTAT
GCGTAACGTAC -> CGTAACGTACA
GCGTCATCGGC -> CGTCATCGGCG
GCGTGACGCGC -> CGTGACGCGCT
GCGTGAGGGAT -> CGTGAGGGATG
GCGTGGCGCCG -> CGTGGCGCCGT
GCGTGTGCGCG -> CGTGTGCGCGG
GCGTTAGATTG -> CGTTAGATTGC
GCGTTAGTTCT -> CGTTAGTTCTC
GCGTTATCATT -> CGTTATCATTA
GCTAAATGAGA -> CTAAATGAGAA
GCTAACAACGA -> CTAACAACGAA
GCTAACATCCA -> CTAACATCCAC
GCTACCTTTCA -> CTACCTTTCAA
GCTACGGGTCT -> CTACGGGTCTA
GCTACGTACAC -> CTACGTACACA
GCTACTTGGAC -> CTACTTGGACT
GCTAGAGTTGT -> CTAGAGTTGTC
GCTATGAGCTC -> CTATGAGCTCG
GCTATTAATTC -> CTATTAATTCA
GCTCAACGTCG -> CTCAACGTCGT
GCTCACGGTCC -> CTCACGGTCCA
GCTCACTACGA -> CTCACTACGAC
GCTCATGGCCT -> CTCATGGCCTG
GCTCCGGGACC -> CTCCGGGACCA
GCTCCTCGTTG -> CTCCTCGTTGA
GCTCCTTGATG -> CTCCTTGATGT
GCTCGGCTCAC -> CTCGGCTCACG
GCTCGTAAGTT -> CTCGTAAGTTT
GCTCGTTACAT -> CTCGTTACATT
GCTCTCAGCGC -> CTCTCAGCGCG
GCTGACACATG -> CTGACACATGT
GCTGATACAAG -> CTGATACAAGT
GCTGCCGTTAG -> CTGCCGTTAGT
GCTGCGTGAGG -> CTGCGTGAGGG
GCTGCGTTAGT -> CTGCGTTAGTT
GCTGGACTCTG -> CTGGACTCTGG
GCTGGCACTGC -> CTGGCACTGCT
GCTGGCTCCTT -> CTGGCTCCTTG
GCTGGGAGAGG -> CTGGGAGAGGT
GCTGGGGGTGC -> CTGGGGGTGCC
GCTGGTGCGAG -> CTGGTGCGAGT
GCTGGTTTACC -> CTGGTTTACCC
GCTGTAGGGCC -> CTGTAGGGCCG
GCTGTCCATGC -> CTGTCCATGCC
GCTGTTGCAGA -> CTGTTGCAGAC
GCTTACGCCGC -> CTTACGCCGCC
GCTTCATTGCT -> CTTCATTGCTT
GCTTCCGAAGA -> CTTCCGAAGAG
GCTTCCGTGCG -> CTTCCGTGCGT
GCTTGATCATG -> CTTGATCATGA
GCTTGCGCAAG -> CTTGCGCAAGC
GCTTGCTAAAT -> CTTGCTAAATG
GCTTGCTCGTA -> CTTGCTCGTAA
GCTTGTCCGCA -> CTTGTCCGCAA
GGAACCTAACC -> GAACCTAACCC
GGAACCTGCGG -> GAACCTGCGGC
GGAACTGTGAA -> GAACTGTGAAA
GGAAGCTTCCG -> GAAGCTTCCGA
GGAATACAATA -> GAATACAATAG
GGAATGGTTCA -> GAATGGTTCAT
GGACCAGTATT -> GACCAGTATTT
GGACCGAAGAA -> GACCGAAGAAT
GGACCGATTTT -> GACCGATTTTC
GGACGAGACCT -> GACGAGACCTT
GGACGCAGGAG -> GACGCAGGAGT
GGACGCGGTTG -> GACGCGGTTGC
GGACGGAATGG -> GACGGAATGGT
GGACGTACGGG -> GACGTACGGGC
GGACGTAGTCG -> GACGTAGTCGA
GGACGTGCTAA -> GACGTGCTAAC
GGACTCTGGTT -> GACTCTGGTTT
GGACTCTTATA -> GACTCTTATAT
GGACTTACGTA -> GACTTACGTAG
GGAGACGATTA -> GAGACGATTAA
GGAGACTGATG -> GAGACTGATGC
GGAGAGGTTGA -> GAGAGGTTGAG
GGAGCTCCTCG -> GAGCTCCTCGT
GGAGCTCTCAG -> GAGCTCTCAGC
GGAGGAGACGA -> GAGGAGACGAT
GGAGGAGCTCC -> GAGGAGCTCCT
GGAGGTACGCT -> GAGGTACGCTA
GGAGTAGCGTG -> GAGTAGCGTGT
GGAGTGGCGTT -> GAGTGGCGTTA
GGATAACATTA -> GATAACATTAC
GGATACATGTT -> GATACATGTTA
GGATCTATCAC -> GATCTATCACG
GGATGTAACAT -> GATGTAACATA
GGATGTTACAT -> GATGTTACATC
GGCAACAACCG -> GCAACAACCGC
GGCAACGACTT -> GCAACGACTTA
GGCAAGTCGAT -> GCAAGTCGATA
GGCAATCGGGG -> GCAATCGGGGT
GGCACAGCCGG -> GCACAGCCGGA
GGCACTGCTGT -> GCACTGCTGTT
GGCCACAATAC -> GCCACAATACC
GGCCATTGCTA -> GCCATTGCTAT
GGCCCAGGCTA -> GCCCAGGCTAC
GGCCCGCCATC -> GCCCGCCATCA
GGCCGCCAGCC -> GCCGCCAGCCG
GGCCGGGAACC -> GCCGGGAACCT
GGCCTGCGCGC -> GCCTGCGCGCC
GGCGCATGATT -> GCGCATGATTC
GGCGCCGTATT -> GCGCCGTATTC
GGCGCTGGTGC -> GCGCTGGTGCG
GGCGCTTGATC -> GCGCTTGATCA
GGCGGAATACA -> GCGGAATACAA
GGCGTGGCGCC -> GCGTGGCGCCG
GGCGTTAGATT -> GCGTTAGATTG
GGCTACCTTTC -> GCTACCTTTCA
GGCTCAACGTC -> GCTCAACGTCG
GGCTCACGGTC -> GCTCACGGTCC
GGCTCACTACG -> GCTCACTACGA
GGCTCATGGCC -> GCTCATGGCCT
GGCTCCGGGAC -> GCTCCGGGACC
GGCTCCTTGAT -> GCTCCTTGATG
GGCTCGTTACA -> GCTCGTTACAT
GGCTGGCACTG -> GCTGGCACTGC
GGCTGGGGGTG -> GCTGGGGGTGC
GGCTTCATTGC -> GCTTCATTGCT
GGGAACCTGCG -> GGAACCTGCGG
GGGAAGCTTCC -> GGAAGCTTCCG
GGGACCAGTAT -> GGACCAGTATT
GGGAGACTGAT -> GGAGACTGATG
GGGAGAGGTTG -> GGAGAGGTTGA
GGGAGGAGCTC -> GGAGGAGCTCC
GGGATACATGT -> GGATACATGTT
GGGATGTTACA -> GGATGTTACAT
GGGCAACAACC -> GGCAACAACCG
GGGCAACGACT -> GGCAACGACTT
GGGCAATCGGG -> GGCAATCGGGG
GGGCCGCCAGC -> GGCCGCCAGCC
GGGCGGAATAC -> GGCGGAATACA
GGGCTCATGGC -> GGCTCATGGCC
GGGCTCCGGGA -> GGCTCCGGGAC
GGGCTCGTTAC -> GGCTCGTTACA
GGGGAGGAGCT -> GGGAGGAGCTC
GGGGATACATG -> GGGATACATGT
GGGGCGGAATA -> GGGCGGAATAC
GGGGGAGGAGC -> GGGGAGGAGCT
GGGGGTGCCCG -> GGGGTGCCCGG
GGGGTACATAT -> GGGTACATATG
GGGGTAGGAAC -> GGGTAGGAACC
GGGGTGCCCGG -> GGGTGCCCGGG
GGGTACATATG -> GGTACATATGG
GGGTAGGAACC -> GGTAGGAACCT
GGGTCTAGGGA -> GGTCTAGGGAG
GGGTGCCCGGG -> GGTGCCCGGGC
GGGTGTTTAAG -> GGTGTTTAAGA
GGTACATATGG -> GTACATATGGT
GGTACGCCGCT -> GTACGCCGCTG
GGTACGCTACT -> GTACGCTACTT
GGTAGCTATTA -> GTAGCTATTAA
GGTAGGAACCT -> GTAGGAACCTA
GGTATCGCGTG -> GTATCGCGTGA
GGTCATGCATA -> GTCATGCATAT
GGTCCATAGGG -> GTCCATAGGGC
GGTCCTTGACG -> GTCCTTGACGC
GGTCGATGTAG -> GTCGATGTAGA
GGTCTAGGGAG -> GTCTAGGGAGA
GGTGAAACGTC -> GTGAAACGTCA
GGTGAGAGCTT -> GTGAGAGCTTC
GGTGAGTACTC -> GTGAGTACTCG
GGTGCCCGGGC -> GTGCCCGGGCT
GGTGCGAGTAG -> GTGCGAGTAGA
GGTGGAACTGT -> GTGGAACTGTG
GGTGTTGCAGA -> GTGTTGCAGAG
GGTGTTTAAGA -> GTGTTTAAGAC
GGTTACTTCTG -> GTTACTTCTGA
GGTTAGCCCTG -> GTTAGCCCTGG
GGTTCATGTAT -> GTTCATGTATT
GGTTCGCGGAG -> GTTCGCGGAGT
GGTTCTTTAAA -> GTTCTTTAAAA
GGTTGAGGTAG -> GTTGAGGTAGC
GGTTGCCTATA -> GTTGCCTATAG
GGTTTACCCAA -> GTTTACCCAAT
GGTTTAGATGA -> GTTTAGATGAA
GGTTTCGGTCG -> GTTTCGGTCGA
GTAACATAAGG -> TAACATAAGGT
GTAACGTACAC -> TAACGTACACG
GTAAGCCTCAT -> TAAGCCTCATG
GTAAGGCGCAT -> TAAGGCGCATG
GTAAGTTTTCA -> TAAGTTTTCAC
GTAATAAAGTT -> TAATAAAGTTA
GTACACACAAA -> TACACACAAAT
GTACACGCCTG -> TACACGCCTGA
GTACAGACGCG -> TACAGACGCGA
GTACATATGGT -> TACATATGGTA
GTACGCCGCTG -> TACGCCGCTGT
GTACGCTACTT -> TACGCTACTTG
GTACGGATGTA -> TACGGATGTAA
GTACGGGCAAC -> TACGGGCAACG
GTACGTTCCGG -> TACGTTCCGGC
GTACTAGCCCT -> TACTAGCCCTG
GTACTCGAAGG -> TACTCGAAGGA
GTAGACATCCA -> TAGACATCCAC
GTAGATACGCT -> TAGATACGCTG
GTAGCCCAAGA -> TAGCCCAAGAA
GTAGCGCAACC -> TAGCGCAACCA
GTAGCGTGTGC -> TAGCGTGTGCG
GTAGCTATTAA -> TAGCTATTAAT
GTAGGAACCTA -> TAGGAACCTAA
GTAGGGCCGCC -> TAGGGCCGCCA
GTAGGTTCGCG -> TAGGTTCGCGG
GTAGTCGACCC -> TAGTCGACCCT
GTATATTTTGG -> TATATTTTGGG
GTATCCTGCTT -> TATCCTGCTTA
GTATCGCGTGA -> TATCGCGTGAC
GTATGGCAAGT -> TATGGCAAGTC
GTATTCTGGAC -> TATTCTGGACG
GTATTGCTTGT -> TATTGCTTGTC
GTATTTCTTGG -> TATTTCTTGGC
GTCACCACTCT -> TCACCACTCTC
GTCAGATGGGG -> TCAGATGGGGT
GTCAGTCCGGC -> TCAGTCCGGCC
GTCATCGGCGC -> TCATCGGCGCT
GTCATGCATAT -> TCATGCATATC
GTCATGGGCAA -> TCATGGGCAAT
GTCATTAGCGC -> TCATTAGCGCT
GTCCATAGGGC -> TCCATAGGGCT
GTCCATGCCTC -> TCCATGCCTCG
GTCCATGCTGG -> TCCATGCTGGC
GTCCGCAAACC -> TCCGCAAACCC
GTCCGGCCCAG -> TCCGGCCCAGG
GTCCTTGACGC -> TCCTTGACGCC
GTCGAAATGCT -> TCGAAATGCTG
GTCGACCCTTC -> TCGACCCTTCA
GTCGATAGCCT -> TCGATAGCCTT
GTCGATGTAGA -> TCGATGTAGAT
GTCGCAGTTCT -> TCGCAGTTCTA
GTCGGATAACA -> TCGGATAACAT
GTCGTTAGATT -> TCGTTAGATTA
GTCTAGGAGCT -> TCTAGGAGCTC
GTCTAGGGAGA -> TCTAGGGAGAC
GTCTCCTTAGT -> TCTCCTTAGTA
GTGAAACACCG -> TGAAACACCGG
GTGAAACGTCA -> TGAAACGTCAG
GTGAATTCCTC -> TGAATTCCTCA
GTGACGCGCTG -> TGACGCGCTGG
GTGAGAGCTTC -> TGAGAGCTTCC
GTGAGGGATGT -> TGAGGGATGTT
GTGAGGTGAGA -> TGAGGTGAGAG
GTGAGTACTCG -> TGAGTACTCGA
GTGAGTGAGTG -> TGAGTGAGTGT
GTGAGTGTGGA -> TGAGTGTGGAG
GTGATGTGAGT -> TGATGTGAGTG
GTGCACGCGCT -> TGCACGCGCTG
GTGCAGTACAG -> TGCAGTACAGA
GTGCCACCATG -> TGCCACCATGA
GTGCCCGGGCT -> TGCCCGGGCTC
GTGCGAGTAGA -> TGCGAGTAGAC
GTGCGCGGCTG -> TGCGCGGCTGG
GTGCGTTATCA -> TGCGTTATCAT
GTGCTAACATC -> TGCTAACATCC
GTGCTAGAGTT -> TGCTAGAGTTG
GTGGAACTGTG -> TGGAACTGTGA
GTGGAGGTACG -> TGGAGGTACGC
GTGGCGCCGTA -> TGGCGCCGTAT
GTGGCGTTAGA -> TGGCGTTAGAT
GTGTGCGCGGC -> TGTGCGCGGCT
GTGTGGAGGTA -> TGTGGAGGTAC
GTGTGTTATTG -> TGTGTTATTGA
GTGTTATTGAC -> TGTTATTGACA
GTGTTGCAGAG -> TGTTGCAGAGA
GTGTTTAAGAC -> TGTTTAAGACT
GTGTTTTCGTT -> TGTTTTCGTTG
GTTAAACAAAG -> TTAAACAAAGT
GTTAATGGTGA -> TTAATGGTGAA
GTTACACCAAG -> TTACACCAAGA
GTTACATCATG -> TTACATCATGA
GTTACATTCGC -> TTACATTCGCC
GTTACTACGTG -> TTACTACGTGC
GTTACTTCTGA -> TTACTTCTGAA
GTTAGATATAG -> TTAGATATAGC
GTTAGATTATA -> TTAGATTATAG
GTTAGATTGCA -> TTAGATTGCAG
GTTAGCCCTGG -> TTAGCCCTGGT
GTTAGGACGGA -> TTAGGACGGAA
GTTAGTATGGC -> TTAGTATGGCA
GTTAGTCTAGG -> TTAGTCTAGGA
GTTAGTTCTCA -> TTAGTTCTCAT
GTTATCATTAC -> TTATCATTACA
GTTATTGACAC -> TTATTGACACT
GTTCATGTATT -> TTCATGTATTG
GTTCATGTGAG -> TTCATGTGAGG
GTTCCGGCGCT -> TTCCGGCGCTG
GTTCGCGGAGT -> TTCGCGGAGTA
GTTCGGTTAGC -> TTCGGTTAGCC
GTTCGTCGAAA -> TTCGTCGAAAT
GTTCTACCCTA -> TTCTACCCTAG
GTTCTCATGGA -> TTCTCATGGAC
GTTCTTTAAAA -> TTCTTTAAAAA
GTTGAAGTCAC -> TTGAAGTCACC
GTTGAGGTAGC -> TTGAGGTAGCT
GTTGCAGACCA -> TTGCAGACCAT
GTTGCAGAGAT -> TTGCAGAGATG
GTTGCCTATAG -> TTGCCTATAGC
GTTGTCGCAGT -> TTGTCGCAGTT
GTTGTTAATGG -> TTGTTAATGGT
GTTTAAGACTA -> TTTAAGACTAT
GTTTACCCAAT -> TTTACCCAATG
GTTTAGATGAA -> TTTAGATGAAG
GTTTCGGTCGA -> TTTCGGTCGAT
GTTTGCGCAGC -> TTTGCGCAGCA
GTTTTCACCGG -> TTTTCACCGGT
GTTTTCGTTGT -> TTTTCGTTGTT
TAAAAAAGTCA -> AAAAAAGTCAT
TAAACAAAGTC -> AAACAAAGTCT
TAAAGACGCAC -> AAAGACGCACG
TAAAGTTACTA -> AAAGTTACTAC
TAAATGAGAAG -> AAATGAGAAGG
TAACAACGAAA -> AACAACGAAAT
TAACATAAGGT -> AACATAAGGTC
TAACATCCACA -> AACATCCACAC
TAACATTACTT -> AACATTACTTT
TAACCAAGTGC -> AACCAAGTGCA
TAACCCCATCC -> AACCCCATCCT
TAACGTACACG -> AACGTACACGC
TAAGACTATGG -> AAGACTATGGG
TAAGACTTCGG -> AAGACTTCGGT
TAAGAGCACGG -> AAGAGCACGGA
TAAGCCTCATG -> AAGCCTCATGA
TAAGCGTCATC -> AAGCGTCATCG
TAAGGCCGGGA -> AAGGCCGGGAA
TAAGGCGCATG -> AAGGCGCATGA
TAAGGTCCTTG -> AAGGTCCTTGA
TAAGTTTTCAC -> AAGTTTTCACC
TAATAAAGTTA -> AATAAAGTTAC
TAATGGTGAAA -> AATGGTGAAAC
TAATTCAGTGC -> AATTCAGTGCA
TACAAGTGAAT -> ACAAGTGAATT
TACAATAGCAT -> ACAATAGCATC
TACACACAAAT -> ACACACAAATG
TACACACAGGT -> ACACACAGGTT
TACACCAAGAT -> ACACCAAGATA
TACACGCCTGA -> ACACGCCTGAA
TACAGACGCGA -> ACAGACGCGAA
TACATATGGTA -> ACATATGGTAC
TACATCATGAT -> ACATCATGATC
TACATGTTAAA -> ACATGTTAAAC
TACATTCGCCG -> ACATTCGCCGT
TACCCAATGTA -> ACCCAATGTAA
TACCCTAGCCG -> ACCCTAGCCGG
TACCGCTGCGT -> ACCGCTGCGTT
TACCGTGATGT -> ACCGTGATGTG
TACCTAAGAGC -> ACCTAAGAGCA
TACCTTCACTT -> ACCTTCACTTA
TACCTTTCAAC -> ACCTTTCAACC
TACGAATGTTC -> ACGAATGTTCG
TACGACCGCTG -> ACGACCGCTGG
TACGAGTACGT -> ACGAGTACGTT
TACGCCGCCCG -> ACGCCGCCCGT
TACGCCGCTGT -> ACGCCGCTGTA
TACGCTACTTG -> ACGCTACTTGG
TACGCTGTCCA -> ACGCTGTCCAT
TACGGACGAGA -> ACGGACGAGAC
TACGGATGTAA -> ACGGATGTAAC
TACGGGCAACG -> ACGGGCAACGA
TACGGGTCTAG -> ACGGGTCTAGG
TACGTACACAC -> ACGTACACACA
TACGTAGCGCA -> ACGTAGCGCAA
TACGTGCTAGA -> ACGTGCTAGAG
TACGTTCCGGC -> ACGTTCCGGCG
TACTACCTTCA -> ACTACCTTCAC
TACTACGTGCT -> ACTACGTGCTA
TACTACTTACC -> ACTACTTACCG
TACTAGCCCTG -> ACTAGCCCTGG
TACTCGAAGGA -> ACTCGAAGGAC
TACTGACTCTT -> ACTGACTCTTG
TACTTACCGCT -> ACTTACCGCTG
TACTTCTGAAT -> ACTTCTGAATT
TACTTGGACTC -> ACTTGGACTCT
TACTTTTTCTA -> ACTTTTTCTAA
TAGACATCCAC -> AGACATCCACT
TAGAGTTGTCG -> AGAGTTGTCGC
TAGATACGCTG -> AGATACGCTGT
TAGATATAGCA -> AGATATAGCAT
TAGATGAAGCA -> AGATGAAGCAT
TAGATTATAGT -> AGATTATAGTA
TAGATTGCAGT -> AGATTGCAGTA
TAGCATCCCCT -> AGCATCCCCTG
TAGCATCTCCG -> AGCATCTCCGA
TAGCATTGTTT -> AGCATTGTTTG
TAGCCCAAGAA -> AGCCCAAGAAG
TAGCCCTGGAC -> AGCCCTGGACC
TAGCCCTGGTA -> AGCCCTGGTAT
TAGCCGGACGT -> AGCCGGACGTA
TAGCCTTCGGA -> AGCCTTCGGAC
TAGCGCAACCA -> AGCGCAACCAT
TAGCGCTAACA -> AGCGCTAACAA
TAGCGTGTGCG -> AGCGTGTGCGC
TAGCTATTAAT -> AGCTATTAATT
TAGCTGACACA -> AGCTGACACAT
TAGGAACCTAA -> AGGAACCTAAC
TAGGACGGAAT -> AGGACGGAATG
TAGGAGCTCTC -> AGGAGCTCTCA
TAGGGAGACTG -> AGGGAGACTGA
TAGGGCCGCCA -> AGGGCCGCCAG
TAGGGCTCCGG -> AGGGCTCCGGG
TAGGTTCGCGG -> AGGTTCGCGGA
TAGTAAGCCTC -> AGTAAGCCTCA
TAGTATCCTGC -> AGTATCCTGCT
TAGTATGGCAA -> AGTATGGCAAG
TAGTCGACCCT -> AGTCGACCCTT
TAGTCTAGGAG -> AGTCTAGGAGC
TAGTTCTCATG -> AGTTCTCATGG
TATAGCATTGT -> ATAGCATTGTT
TATAGCTGACA -> ATAGCTGACAC
TATAGTAAGCC -> ATAGTAAGCCT
TATATTGGGGG -> ATATTGGGGGA
TATATTTTGGG -> ATATTTTGGGC
TATCACGTACT -> ATCACGTACTA
TATCATTACAC -> ATCATTACACA
TATCCTGCTTA -> ATCCTGCTTAC
TATCGCGTGAC -> ATCGCGTGACG
TATCGGGAAGC -> ATCGGGAAGCT
TATCTTACTGA -> ATCTTACTGAC
TATGAATATGG -> ATGAATATGGA
TATGAGCTCGG -> ATGAGCTCGGC
TATGATCTCTC -> ATGATCTCTCG
TATGGAGGAGA -> ATGGAGGAGAC
TATGGCAAGTC -> ATGGCAAGTCG
TATGGGCTCAT -> ATGGGCTCATG
TATGGTACGCC -> ATGGTACGCCG
TATGTTCATGT -> ATGTTCATGTG
TATTAATTCAG -> ATTAATTCAGT
TATTCGACCAT -> ATTCGACCATT
TATTCTGGACG -> ATTCTGGACGT
TATTGACACTT -> ATTGACACTTT
TATTGCTTGTC -> ATTGCTTGTCC
TATTGGGGGAG -> ATTGGGGGAGG
TATTTCTTGGC -> ATTTCTTGGCA
TATTTTGGGCA -> ATTTTGGGCAA
TCAACCCACGC -> CAACCCACGCG
TCAACGTCGTT -> CAACGTCGTTA
TCAATTCACAC -> CAATTCACACC
TCACACCATAT -> CACACCATATT
TCACCACTCTC -> CACCACTCTCC
TCACCGGTTCT -> CACCGGTTCTT
TCACGCCGCAG -> CACGCCGCAGC
TCACGGTCCAT -> CACGGTCCATA
TCACGTACTAG -> CACGTACTAGC
TCACTACGACC -> CACTACGACCG
TCACTCATGTT -> CACTCATGTTC
TCACTTACGGA -> CACTTACGGAC
TCAGATGGGGT -> CAGATGGGGTA
TCAGCGCGACT -> CAGCGCGACTC
TCAGTCCGGCC -> CAGTCCGGCCC
TCAGTGCACGC -> CAGTGCACGCG
TCATACGAGTA -> CATACGAGTAC
TCATCGGCGCT -> CATCGGCGCTT
TCATGACTATC -> CATGACTATCT
TCATGATCAAT -> CATGATCAATT
TCATGATCCCC -> CATGATCCCCG
TCATGATCGGA -> CATGATCGGAT
TCATGCATATC -> CATGCATATCG
TCATGGCCACA -> CATGGCCACAA
TCATGGCCTGC -> CATGGCCTGCG
TCATGGGCAAT -> CATGGGCAATC
TCATGTATTGC -> CATGTATTGCT
TCATGTGAGGT -> CATGTGAGGTG
TCATGTTCGGT -> CATGTTCGGTT
TCATTACACAC -> CATTACACACA
TCATTAGCGCT -> CATTAGCGCTA
TCATTGCTTGC -> CATTGCTTGCG
TCCAACACTAC -> CCAACACTACT
TCCACACCTAT -> CCACACCTATG
TCCACTACCGT -> CCACTACCGTG
TCCATAAAGAC -> CCATAAAGACG
TCCATAGGGCT -> CCATAGGGCTC
TCCATGCCTCG -> CCATGCCTCGA
TCCATGCTGGC -> CCATGCTGGCT
TCCCCGCGGGT -> CCCCGCGGGTG
TCCCCTGCGCT -> CCCCTGCGCTG
TCCGAACATCC -> CCGAACATCCA
TCCGAAGAGAT -> CCGAAGAGATG
TCCGCAAACCC -> CCGCAAACCCA
TCCGGCCCAGG -> CCGGCCCAGGC
TCCGGCGCTGG -> CCGGCGCTGGT
TCCGGGACCAG -> CCGGGACCAGT
TCCGTGCGTTA -> CCGTGCGTTAT
TCCTCATGGCC -> CCTCATGGCCA
TCCTCGTTGAA -> CCTCGTTGAAG
TCCTGCTTACG -> CCTGCTTACGC
TCCTGTGCCAC -> CCTGTGCCACC
TCCTTAGTATC -> CCTTAGTATCC
TCCTTGACGCC -> CCTTGACGCCG
TCCTTGATGTG -> CCTTGATGTGT
TCCTTGCATCC -> CCTTGCATCCA
TCCTTGCGTAA -> CCTTGCGTAAC
TCGAAATGCTG -> CGAAATGCTGC
TCGAAGGACGC -> CGAAGGACGCA
TCGACCATTGG -> CGACCATTGGC
TCGACCCTTCA -> CGACCCTTCAC
TCGACCTGTAA -> CGACCTGTAAG
TCGACCTTGCG -> CGACCTTGCGC
TCGATAGCCTT -> CGATAGCCTTC
TCGATGTAGAT -> CGATGTAGATA
TCGCAGTTCTA -> CGCAGTTCTAC
TCGCCGTTAGG -> CGCCGTTAGGA
TCGCGGAGTAG -> CGCGGAGTAGC
TCGCGTGACGC -> CGCGTGACGCG
TCGCTTGCTCG -> CGCTTGCTCGT
TCGGACTTACG -> CGGACTTACGT
TCGGATAACAT -> CGGATAACATT
TCGGATCTATC -> CGGATCTATCA
TCGGCCATTGC -> CGGCCATTGCT
TCGGCGCTTGA -> CGGCGCTTGAT
TCGGCTCACGG -> CGGCTCACGGT
TCGGCTTCATT -> CGGCTTCATTG
TCGGGAAGCTT -> CGGGAAGCTTC
TCGGGGATACA -> CGGGGATACAT
TCGGGGTAGGA -> CGGGGTAGGAA
TCGGTCGATGT -> CGGTCGATGTA
TCGGTGAGTAC -> CGGTGAGTACT
TCGGTTAGCCC -> CGGTTAGCCCT
TCGTAAGTTTT -> CGTAAGTTTTC
TCGTCGAAATG -> CGTCGAAATGC
TCGTTACACCA -> CGTTACACCAA
TCGTTACATTC -> CGTTACATTCG
TCGTTAGATTA -> CGTTAGATTAT
TCGTTGAAGTC -> CGTTGAAGTCA
TCGTTGTTAAT -> CGTTGTTAATG
TCTAAGCGTCA -> CTAAGCGTCAT
TCTACCCTAGC -> CTACCCTAGCC
TCTAGGAGCTC -> CTAGGAGCTCT
TCTAGGGAGAC -> CTAGGGAGACT
TCTATCACGTA -> CTATCACGTAC
TCTCAGCGCGA -> CTCAGCGCGAC
TCTCCGAACAT -> CTCCGAACATC
TCTCCTTAGTA -> CTCCTTAGTAT
TCTCCTTGCGT -> CTCCTTGCGTA
TCTCGCTTGCT -> CTCGCTTGCTC
TCTCGTTACAC -> CTCGTTACACC
TCTCTCGCTTG -> CTCTCGCTTGC
TCTGAATTTCG -> CTGAATTTCGG
TCTGGACGTGC -> CTGGACGTGCT
TCTGGTTTCGG -> CTGGTTTCGGT
TCTTACTACTT -> CTTACTACTTA
TCTTACTGACT -> CTTACTGACTC
TCTTATATTGG -> CTTATATTGGG
TCTTGGCACAG -> CTTGGCACAGC
TCTTGTGTTTT -> CTTGTGTTTTC
TCTTTAAAAAA -> CTTTAAAAAAG
TCTTTATGATC -> CTTTATGATCT
TGAAACACCGG -> GAAACACCGGT
TGAAACGTCAG -> GAAACGTCAGA
TGAAGCATTTG -> GAAGCATTTGC
TGAAGTCACCA -> GAAGTCACCAC
TGAATATGGAG -> GAATATGGAGG
TGAATCTTTAT -> GAATCTTTATG
TGAATTCCTCA -> GAATTCCTCAT
TGAATTTCGGC -> GAATTTCGGCT
TGACACATGTA -> GACACATGTAG
TGACACTTTTC -> GACACTTTTCG
TGACCGATCTT -> GACCGATCTTA
TGACGCCGGTG -> GACGCCGGTGT
TGACGCGCTGG -> GACGCGCTGGG
TGACTATCTTA -> GACTATCTTAC
TGACTCTTGTG -> GACTCTTGTGT
TGAGAAGGTGG -> GAGAAGGTGGA
TGAGACGTTAG -> GAGACGTTAGT
TGAGAGCTTCC -> GAGAGCTTCCG
TGAGCTCGGCT -> GAGCTCGGCTC
TGAGGGATGTT -> GAGGGATGTTA
TGAGGTAGCTA -> GAGGTAGCTAT
TGAGGTGAGAG -> GAGGTGAGAGC
TGAGTACTCGA -> GAGTACTCGAA
TGAGTGAGTGT -> GAGTGAGTGTG
TGAGTGTGGAG -> GAGTGTGGAGG
TGATACAAGTG -> GATACAAGTGA
TGATCAATTCA -> GATCAATTCAC
TGATCATGATC -> GATCATGATCC
TGATCCCCGCG -> GATCCCCGCGG
TGATCGGATCT -> GATCGGATCTA
TGATCTCTCGC -> GATCTCTCGCT
TGATGCCAGGA -> GATGCCAGGAC
TGATGTGAGTG -> GATGTGAGTGA
TGATGTGTGTT -> GATGTGTGTTA
TGATTCGGCCA -> GATTCGGCCAT
TGCACGCGCTG -> GCACGCGCTGG
TGCAGACCATC -> GCAGACCATCA
TGCAGAGATGG -> GCAGAGATGGC
TGCAGTACAGA -> GCAGTACAGAC
TGCAGTAGGTT -> GCAGTAGGTTC
TGCATATCGGG -> GCATATCGGGA
TGCATCCATAA -> GCATCCATAAA
TGCCACCATGA -> GCCACCATGAG
TGCCAGGACGC -> GCCAGGACGCG
TGCCCACAGTA -> GCCCACAGTAC
TGCCCGGGCTC -> GCCCGGGCTCG
TGCCGTTAGTC -> GCCGTTAGTCT
TGCCTATAGCT -> GCCTATAGCTG
TGCCTCGACCT -> GCCTCGACCTT
TGCGAGTAGAC -> GCGAGTAGACA
TGCGCAAGCTA -> GCGCAAGCTAC
TGCGCAGCACA -> GCGCAGCACAG
TGCGCGACGTC -> GCGCGACGTCC
TGCGCGCCTCC -> GCGCGCCTCCT
TGCGCGGCTGG -> GCGCGGCTGGG
TGCGCTGATAC -> GCGCTGATACA
TGCGGCCCGCC -> GCGGCCCGCCA
TGCGTAACGTA -> GCGTAACGTAC
TGCGTGAGGGA -> GCGTGAGGGAT
TGCGTTAGTTC -> GCGTTAGTTCT
TGCGTTATCAT -> GCGTTATCATT
TGCTAAATGAG -> GCTAAATGAGA
TGCTAACATCC -> GCTAACATCCA
TGCTAGAGTTG -> GCTAGAGTTGT
TGCTATGAGCT -> GCTATGAGCTC
TGCTCGTAAGT -> GCTCGTAAGTT
TGCTGCGTGAG -> GCTGCGTGAGG
TGCTGGCTCCT -> GCTGGCTCCTT
TGCTGTTGCAG -> GCTGTTGCAGA
TGCTTACGCCG -> GCTTACGCCGC
TGCTTGCGCAA -> GCTTGCGCAAG
TGCTTGCTAAA -> GCTTGCTAAAT
TGCTTGTCCGC -> GCTTGTCCGCA
TGGAACTGTGA -> GGAACTGTGAA
TGGACCGATTT -> GGACCGATTTT
TGGACGTGCTA -> GGACGTGCTAA
TGGACTCTGGT -> GGACTCTGGTT
TGGACTCTTAT -> GGACTCTTATA
TGGAGGAGACG -> GGAGGAGACGA
TGGAGGTACGC -> GGAGGTACGCT
TGGCAAGTCGA -> GGCAAGTCGAT
TGGCACAGCCG -> GGCACAGCCGG
TGGCACTGCTG -> GGCACTGCTGT
TGGCCACAATA -> GGCCACAATAC
TGGCCTGCGCG -> GGCCTGCGCGC
TGGCGCCGTAT -> GGCGCCGTATT
TGGCGTGGCGC -> GGCGTGGCGCC
TGGCGTTAGAT -> GGCGTTAGATT
TGGCTCACTAC -> GGCTCACTACG
TGGCTCCTTGA -> GGCTCCTTGAT
TGGCTGGCACT -> GGCTGGCACTG
TGGGAGAGGTT -> GGGAGAGGTTG
TGGGCAACAAC -> GGGCAACAACC
TGGGCAATCGG -> GGGCAATCGGG
TGGGCTCATGG -> GGGCTCATGGC
TGGGGGAGGAG -> GGGGGAGGAGC
TGGGGGTGCCC -> GGGGGTGCCCG
TGGGGTACATA -> GGGGTACATAT
TGGTACGCCGC -> GGTACGCCGCT
TGGTATCGCGT -> GGTATCGCGTG
TGGTGAAACGT -> GGTGAAACGTC
TGGTGCGAGTA -> GGTGCGAGTAG
TGGTTCATGTA -> GGTTCATGTAT
TGGTTTACCCA -> GGTTTACCCAA
TGGTTTCGGTC -> GGTTTCGGTCG
TGTAACATAAG -> GTAACATAAGG
TGTAAGGCGCA -> GTAAGGCGCAT
TGTAATAAAGT -> GTAATAAAGTT
TGTAGATACGC -> GTAGATACGCT
TGTAGCCCAAG -> GTAGCCCAAGA
TGTAGGGCCGC -> GTAGGGCCGCC
TGTATTGCTTG -> GTATTGCTTGT
TGTCCATGCCT -> GTCCATGCCTC
TGTCCGCAAAC -> GTCCGCAAACC
TGTCGCAGTTC -> GTCGCAGTTCT
TGTCGGATAAC -> GTCGGATAACA
TGTGAAACACC -> GTGAAACACCG
TGTGAGGTGAG -> GTGAGGTGAGA
TGTGAGTGAGT -> GTGAGTGAGTG
TGTGCCACCAT -> GTGCCACCATG
TGTGCGCGGCT -> GTGCGCGGCTG
TGTGGAGGTAC -> GTGGAGGTACG
TGTGTGTTATT -> GTGTGTTATTG
TGTGTTATTGA -> GTGTTATTGAC
TGTGTTTTCGT -> GTGTTTTCGTT
TGTTAAACAAA -> GTTAAACAAAG
TGTTAATGGTG -> GTTAATGGTGA
TGTTACATCAT -> GTTACATCATG
TGTTAGATATA -> GTTAGATATAG
TGTTATTGACA -> GTTATTGACAC
TGTTCATGTGA -> GTTCATGTGAG
TGTTCGGTTAG -> GTTCGGTTAGC
TGTTCGTCGAA -> GTTCGTCGAAA
TGTTGCAGACC -> GTTGCAGACCA
TGTTGCAGAGA -> GTTGCAGAGAT
TGTTTAAGACT -> GTTTAAGACTA
TGTTTGCGCAG -> GTTTGCGCAGC
TGTTTTCGTTG -> GTTTTCGTTGT
TTAAAAAAGTC -> TAAAAAAGTCA
TTAAACAAAGT -> TAAACAAAGTC
TTAACCAAGTG -> TAACCAAGTGC
TTAAGACTATG -> TAAGACTATGG
TTAAGACTTCG -> TAAGACTTCGG
TTAAGGCCGGG -> TAAGGCCGGGA
TTAATGGTGAA -> TAATGGTGAAA
TTAATTCAGTG -> TAATTCAGTGC
TTACACACAGG -> TACACACAGGT
TTACACCAAGA -> TACACCAAGAT
TTACATCATGA -> TACATCATGAT
TTACATTCGCC -> TACATTCGCCG
TTACCCAATGT -> TACCCAATGTA
TTACCGCTGCG -> TACCGCTGCGT
TTACGCCGCCC -> TACGCCGCCCG
TTACGGACGAG -> TACGGACGAGA
TTACGTAGCGC -> TACGTAGCGCA
TTACTACGTGC -> TACTACGTGCT
TTACTACTTAC -> TACTACTTACC
TTACTGACTCT -> TACTGACTCTT
TTACTTCTGAA -> TACTTCTGAAT
TTACTTTTTCT -> TACTTTTTCTA
TTAGATATAGC -> TAGATATAGCA
TTAGATGAAGC -> TAGATGAAGCA
TTAGATTATAG -> TAGATTATAGT
TTAGATTGCAG -> TAGATTGCAGT
TTAGCCCTGGT -> TAGCCCTGGTA
TTAGCGCTAAC -> TAGCGCTAACA
TTAGGACGGAA -> TAGGACGGAAT
TTAGTATCCTG -> TAGTATCCTGC
TTAGTATGGCA -> TAGTATGGCAA
TTAGTCTAGGA -> TAGTCTAGGAG
TTAGTTCTCAT -> TAGTTCTCATG
TTATAGTAAGC -> TATAGTAAGCC
TTATATTGGGG -> TATATTGGGGG
TTATCATTACA -> TATCATTACAC
TTATGATCTCT -> TATGATCTCTC
TTATTGACACT -> TATTGACACTT
TTCAACCCACG -> TCAACCCACGC
TTCACACCATA -> TCACACCATAT
TTCACCGGTTC -> TCACCGGTTCT
TTCACGCCGCA -> TCACGCCGCAG
TTCACTTACGG -> TCACTTACGGA
TTCAGTGCACG -> TCAGTGCACGC
TTCATGATCGG -> TCATGATCGGA
TTCATGTATTG -> TCATGTATTGC
TTCATGTGAGG -> TCATGTGAGGT
TTCATTGCTTG -> TCATTGCTTGC
TTCCGAAGAGA -> TCCGAAGAGAT
TTCCGGCGCTG -> TCCGGCGCTGG
TTCCGTGCGTT -> TCCGTGCGTTA
TTCCTCATGGC -> TCCTCATGGCC
TTCGACCATTG -> TCGACCATTGG
TTCGACCTGTA -> TCGACCTGTAA
TTCGCCGTTAG -> TCGCCGTTAGG
TTCGCGGAGTA -> TCGCGGAGTAG
TTCGGACTTAC -> TCGGACTTACG
TTCGGCCATTG -> TCGGCCATTGC
TTCGGCTTCAT -> TCGGCTTCATT
TTCGGGGATAC -> TCGGGGATACA
TTCGGTCGATG -> TCGGTCGATGT
TTCGGTGAGTA -> TCGGTGAGTAC
TTCGGTTAGCC -> TCGGTTAGCCC
TTCGTCGAAAT -> TCGTCGAAATG
TTCGTTGTTAA -> TCGTTGTTAAT
TTCTAAGCGTC -> TCTAAGCGTCA
TTCTACCCTAG -> TCTACCCTAGC
TTCTCATGGAC -> TCTCATGGACT
TTCTGAATTTC -> TCTGAATTTCG
TTCTGGACGTG -> TCTGGACGTGC
TTCTTGGCACA -> TCTTGGCACAG
TTCTTTAAAAA -> TCTTTAAAAAA
TTGAAGTCACC -> TGAAGTCACCA
TTGACACTTTT -> TGACACTTTTC
TTGACGCCGGT -> TGACGCCGGTG
TTGAGGTAGCT -> TGAGGTAGCTA
TTGATCATGAT -> TGATCATGATC
TTGATGTGTGT -> TGATGTGTGTT
TTGCAGACCAT -> TGCAGACCATC
TTGCAGAGATG -> TGCAGAGATGG
TTGCAGTAGGT -> TGCAGTAGGTT
TTGCATCCATA -> TGCATCCATAA
TTGCCTATAGC -> TGCCTATAGCT
TTGCGCAAGCT -> TGCGCAAGCTA
TTGCGCAGCAC -> TGCGCAGCACA
TTGCGCGACGT -> TGCGCGACGTC
TTGCGTAACGT -> TGCGTAACGTA
TTGCTAAATGA -> TGCTAAATGAG
TTGCTATGAGC -> TGCTATGAGCT
TTGCTCGTAAG -> TGCTCGTAAGT
TTGCTTGCGCA -> TGCTTGCGCAA
TTGCTTGCTAA -> TGCTTGCTAAA
TTGCTTGTCCG -> TGCTTGTCCGC
TTGGACTCTTA -> TGGACTCTTAT
TTGGCACAGCC -> TGGCACAGCCG
TTGGCTCACTA -> TGGCTCACTAC
TTGGGCAACAA -> TGGGCAACAAC
TTGGGGGAGGA -> TGGGGGAGGAG
TTGTCCGCAAA -> TGTCCGCAAAC
TTGTCGCAGTT -> TGTCGCAGTTC
TTGTGTTTTCG -> TGTGTTTTCGT
TTGTTAATGGT -> TGTTAATGGTG
TTGTTTGCGCA -> TGTTTGCGCAG
TTTAAAAAAGT -> TTAAAAAAGTC
TTTAAGACTAT -> TTAAGACTATG
TTTACCCAATG -> TTACCCAATGT
TTTAGATGAAG -> TTAGATGAAGC
TTTATGATCTC -> TTATGATCTCT
TTTCAACCCAC -> TTCAACCCACG
TTTCACCGGTT -> TTCACCGGTTC
TTTCGACCTGT -> TTCGACCTGTA
TTTCGGCTTCA -> TTCGGCTTCAT
TTTCGGGGATA -> TTCGGGGATAC
TTTCGGTCGAT -> TTCGGTCGATG
TTTCGTTGTTA -> TTCGTTGTTAA
TTTCTAAGCGT -> TTCTAAGCGTC
TTTCTTGGCAC -> TTCTTGGCACA
TTTGCGCAGCA -> TTGCGCAGCAC
TTTGCTTGCTA -> TTGCTTGCTAA
TTTGGGCAACA -> TTGGGCAACAA
TTTTCACCGGT -> TTTCACCGGTT
TTTTCGACCTG -> TTTCGACCTGT
TTTTCGGGGAT -> TTTCGGGGATA
TTTTCGTTGTT -> TTTCGTTGTTA
TTTTCTAAGCG -> TTTCTAAGCGT
TTTTGGGCAAC -> TTTGGGCAACA
TTTTTCTAAGC -> TTTTCTAAGCG
